"","Interval","TileID","TotalSittingCapacity","TotalStandingCapacity","TotalCapacity"
"1",1970-01-01 00:30:00,"88a8a02801fffff",33,60,93
"2",1970-01-01 00:30:00,"88a8a02805fffff",33,60,93
"3",1970-01-01 00:30:00,"88a8a02809fffff",93,232,325
"4",1970-01-01 00:30:00,"88a8a0280bfffff",81,131,212
"5",1970-01-01 00:30:00,"88a8a02825fffff",33,60,93
"6",1970-01-01 00:30:00,"88a8a02829fffff",33,60,93
"7",1970-01-01 00:30:00,"88a8a0282dfffff",33,60,93
"8",1970-01-01 00:30:00,"88a8a02853fffff",81,131,212
"9",1970-01-01 00:30:00,"88a8a02857fffff",81,131,212
"10",1970-01-01 00:30:00,"88a8a02919fffff",33,60,93
"11",1970-01-01 00:30:00,"88a8a02953fffff",33,60,93
"12",1970-01-01 00:30:00,"88a8a02a01fffff",171,356,527
"13",1970-01-01 00:30:00,"88a8a02a05fffff",231,459,690
"14",1970-01-01 00:30:00,"88a8a02a0bfffff",120,206,326
"15",1970-01-01 00:30:00,"88a8a02a0dfffff",60,103,163
"16",1970-01-01 00:30:00,"88a8a02a11fffff",120,206,326
"17",1970-01-01 00:30:00,"88a8a02a13fffff",60,103,163
"18",1970-01-01 00:30:00,"88a8a02a19fffff",120,206,326
"19",1970-01-01 00:30:00,"88a8a02a57fffff",120,206,326
"20",1970-01-01 00:30:00,"88a8a02a61fffff",120,206,326
"21",1970-01-01 00:30:00,"88a8a02a63fffff",180,309,489
"22",1970-01-01 00:30:00,"88a8a02a69fffff",120,206,326
"23",1970-01-01 00:30:00,"88a8a02a89fffff",252,487,739
"24",1970-01-01 00:30:00,"88a8a02a8bfffff",219,427,646
"25",1970-01-01 00:30:00,"88a8a02a9dfffff",84,210,294
"26",1970-01-01 00:30:00,"88a8a02aadfffff",48,71,119
"27",1970-01-01 00:30:00,"88a8a02ac5fffff",60,103,163
"28",1970-01-01 00:30:00,"88a8a02ac7fffff",252,487,739
"29",1970-01-01 00:30:00,"88a8a02ae3fffff",81,131,212
"30",1970-01-01 00:30:00,"88a8a02ae7fffff",48,71,119
"31",1970-01-01 00:30:00,"88a8a02aebfffff",81,131,212
"32",1970-01-01 00:30:00,"88a8a03987fffff",60,103,163
"33",1970-01-01 00:30:00,"88a8a03995fffff",60,103,163
"34",1970-01-01 00:30:00,"88a8a03997fffff",180,309,489
"35",1970-01-01 00:30:00,"88a8a039a1fffff",60,103,163
"36",1970-01-01 00:30:00,"88a8a039abfffff",111,253,364
"37",1970-01-01 00:30:00,"88a8a039adfffff",111,253,364
"38",1970-01-01 00:30:00,"88a8a039b9fffff",120,206,326
"39",1970-01-01 00:30:00,"88a8a039bbfffff",120,206,326
"40",1970-01-01 00:30:00,"88a8a06015fffff",0,0,0
"41",1970-01-01 00:30:00,"88a8a06039fffff",0,0,0
"42",1970-01-01 00:30:00,"88a8a06085fffff",168,302,470
"43",1970-01-01 00:30:00,"88a8a0608dfffff",108,199,307
"44",1970-01-01 00:30:00,"88a8a060a3fffff",168,302,470
"45",1970-01-01 00:30:00,"88a8a060abfffff",168,302,470
"46",1970-01-01 00:30:00,"88a8a060c3fffff",168,302,470
"47",1970-01-01 00:30:00,"88a8a060c7fffff",108,199,307
"48",1970-01-01 00:30:00,"88a8a060cbfffff",219,452,671
"49",1970-01-01 00:30:00,"88a8a0618dfffff",0,0,0
"50",1970-01-01 00:30:00,"88a8a06193fffff",108,199,307
"51",1970-01-01 00:30:00,"88a8a06197fffff",48,96,144
"52",1970-01-01 00:30:00,"88a8a061a1fffff",60,103,163
"53",1970-01-01 00:30:00,"88a8a061a3fffff",120,206,326
"54",1970-01-01 00:30:00,"88a8a061a5fffff",162,403,565
"55",1970-01-01 00:30:00,"88a8a061b3fffff",168,302,470
"56",1970-01-01 00:30:00,"88a8a061b5fffff",168,302,470
"57",1970-01-01 00:30:00,"88a8a061b7fffff",168,302,470
"58",1970-01-01 00:30:00,"88a8a061c3fffff",0,0,0
"59",1970-01-01 00:30:00,"88a8a061e7fffff",0,0,0
"60",1970-01-01 00:30:00,"88a8a06213fffff",0,0,0
"61",1970-01-01 00:30:00,"88a8a06249fffff",120,206,326
"62",1970-01-01 00:30:00,"88a8a0624bfffff",111,253,364
"63",1970-01-01 00:30:00,"88a8a0624dfffff",120,206,326
"64",1970-01-01 00:30:00,"88a8a06281fffff",222,506,728
"65",1970-01-01 00:30:00,"88a8a06283fffff",330,705,1035
"66",1970-01-01 00:30:00,"88a8a06287fffff",270,602,872
"67",1970-01-01 00:30:00,"88a8a06289fffff",282,609,891
"68",1970-01-01 00:30:00,"88a8a0628bfffff",120,206,326
"69",1970-01-01 00:30:00,"88a8a06293fffff",60,103,163
"70",1970-01-01 00:30:00,"88a8a062b5fffff",270,602,872
"71",1970-01-01 00:30:00,"88a8a062bdfffff",270,602,872
"72",1970-01-01 00:30:00,"88a8a062c1fffff",120,206,326
"73",1970-01-01 00:30:00,"88a8a062c3fffff",282,609,891
"74",1970-01-01 00:30:00,"88a8a062cbfffff",222,506,728
"75",1970-01-01 00:30:00,"88a8a062d1fffff",60,103,163
"76",1970-01-01 00:30:00,"88a8a062d3fffff",60,103,163
"77",1970-01-01 00:30:00,"88a8a062d9fffff",60,103,163
"78",1970-01-01 00:30:00,"88a8a062e7fffff",0,0,0
"79",1970-01-01 00:30:00,"88a8a062e9fffff",0,0,0
"80",1970-01-01 00:30:00,"88a8a06541fffff",0,0,0
"81",1970-01-01 00:30:00,"88a8a06549fffff",0,0,0
"82",1970-01-01 00:30:00,"88a8a06705fffff",0,0,0
"83",1970-01-01 00:30:00,"88a8a06707fffff",0,0,0
"84",1970-01-01 00:30:00,"88a8a0670dfffff",0,0,0
"85",1970-01-01 00:30:00,"88a8a06735fffff",60,103,163
"86",1970-01-01 00:30:00,"88a8a06739fffff",0,0,0
"87",1970-01-01 00:30:00,"88a8a0674dfffff",60,103,163
"88",1970-01-01 00:30:00,"88a8a0676bfffff",60,103,163
"89",1970-01-01 00:30:00,"88a8a06a91fffff",51,150,201
"90",1970-01-01 00:30:00,"88a8a06a9bfffff",162,403,565
"91",1970-01-01 00:30:00,"88a8a06ad3fffff",0,0,0
"92",1970-01-01 00:30:00,"88a8a06adbfffff",0,0,0
"93",1970-01-01 00:30:00,"88a8a06e49fffff",108,199,307
"94",1970-01-01 00:30:00,"88a8a06e4dfffff",168,302,470
"95",1970-01-01 00:30:00,"88a8a06e6dfffff",120,206,326
"96",1970-01-01 00:30:00,"88a8a06f61fffff",60,103,163
"97",1970-01-01 00:30:00,"88a8a06f67fffff",60,103,163
"98",1970-01-01 00:30:00,"88a8a070b3fffff",171,356,527
"99",1970-01-01 00:30:00,"88a8a070b7fffff",171,356,527
"100",1970-01-01 00:30:00,"88a8a0719bfffff",60,103,163
"101",1970-01-01 00:30:00,"88a8a07441fffff",111,253,364
"102",1970-01-01 00:30:00,"88a8a07445fffff",0,0,0
"103",1970-01-01 00:30:00,"88a8a07447fffff",111,253,364
"104",1970-01-01 00:30:00,"88a8a0744bfffff",51,150,201
"105",1970-01-01 00:30:00,"88a8a07461fffff",171,356,527
"106",1970-01-01 00:30:00,"88a8a07465fffff",111,253,364
"107",1970-01-01 00:30:00,"88a8a07467fffff",120,206,326
"108",1970-01-01 00:30:00,"88a8a07469fffff",0,0,0
"109",1970-01-01 00:30:00,"88a8a0746bfffff",111,253,364
"110",1970-01-01 00:30:00,"88a8a07507fffff",222,506,728
"111",1970-01-01 00:30:00,"88a8a07509fffff",0,0,0
"112",1970-01-01 00:30:00,"88a8a07515fffff",120,206,326
"113",1970-01-01 00:30:00,"88a8a0751dfffff",120,206,326
"114",1970-01-01 00:30:00,"88a8a07521fffff",342,712,1054
"115",1970-01-01 00:30:00,"88a8a07525fffff",282,609,891
"116",1970-01-01 00:30:00,"88a8a0752bfffff",333,759,1092
"117",1970-01-01 00:30:00,"88a8a0752dfffff",402,815,1217
"118",1970-01-01 00:30:00,"88a8a07531fffff",651,1180,1831
"119",1970-01-01 00:30:00,"88a8a07533fffff",60,103,163
"120",1970-01-01 00:30:00,"88a8a07535fffff",111,253,364
"121",1970-01-01 00:30:00,"88a8a07537fffff",60,103,163
"122",1970-01-01 00:30:00,"88a8a07539fffff",180,309,489
"123",1970-01-01 00:30:00,"88a8a0753bfffff",120,206,326
"124",1970-01-01 00:30:00,"88a8a0753dfffff",162,403,565
"125",1970-01-01 00:30:00,"88a8a07543fffff",60,103,163
"126",1970-01-01 00:30:00,"88a8a07545fffff",60,103,163
"127",1970-01-01 00:30:00,"88a8a07547fffff",120,206,326
"128",1970-01-01 00:30:00,"88a8a07553fffff",120,206,326
"129",1970-01-01 00:30:00,"88a8a07557fffff",120,206,326
"130",1970-01-01 00:30:00,"88a8a07559fffff",111,253,364
"131",1970-01-01 00:30:00,"88a8a0755bfffff",120,206,326
"132",1970-01-01 00:30:00,"88a8a0755dfffff",111,253,364
"133",1970-01-01 00:30:00,"88a8a07561fffff",411,768,1179
"134",1970-01-01 00:30:00,"88a8a07565fffff",171,356,527
"135",1970-01-01 00:30:00,"88a8a07567fffff",513,1068,1581
"136",1970-01-01 00:30:00,"88a8a07569fffff",171,356,527
"137",1970-01-01 00:30:00,"88a8a0756bfffff",120,206,326
"138",1970-01-01 00:30:00,"88a8a0756dfffff",471,871,1342
"139",1970-01-01 00:30:00,"88a8a07633fffff",111,253,364
"140",1970-01-01 00:30:00,"88a8a07637fffff",51,150,201
"141",1970-01-01 00:30:00,"88a8a076c7fffff",51,150,201
"142",1970-01-01 00:30:00,"88a8a076e9fffff",111,253,364
"143",1970-01-01 00:30:00,"88a8a076ebfffff",111,253,364
"144",1970-01-01 00:30:00,"88a8a076edfffff",111,253,364
"145",1970-01-01 01:00:00,"88a8a02801fffff",51,150,201
"146",1970-01-01 01:00:00,"88a8a02809fffff",48,71,119
"147",1970-01-01 01:00:00,"88a8a0280bfffff",33,60,93
"148",1970-01-01 01:00:00,"88a8a02853fffff",33,60,93
"149",1970-01-01 01:00:00,"88a8a02857fffff",33,60,93
"150",1970-01-01 01:00:00,"88a8a02a01fffff",51,150,201
"151",1970-01-01 01:00:00,"88a8a02a05fffff",51,150,201
"152",1970-01-01 01:00:00,"88a8a02a0bfffff",51,150,201
"153",1970-01-01 01:00:00,"88a8a02a11fffff",171,356,527
"154",1970-01-01 01:00:00,"88a8a02a13fffff",120,206,326
"155",1970-01-01 01:00:00,"88a8a02a19fffff",111,253,364
"156",1970-01-01 01:00:00,"88a8a02a57fffff",171,356,527
"157",1970-01-01 01:00:00,"88a8a02a61fffff",51,150,201
"158",1970-01-01 01:00:00,"88a8a02a63fffff",51,150,201
"159",1970-01-01 01:00:00,"88a8a02a89fffff",144,313,457
"160",1970-01-01 01:00:00,"88a8a02a8bfffff",144,313,457
"161",1970-01-01 01:00:00,"88a8a02a9dfffff",111,253,364
"162",1970-01-01 01:00:00,"88a8a02aa9fffff",33,60,93
"163",1970-01-01 01:00:00,"88a8a02aadfffff",33,60,93
"164",1970-01-01 01:00:00,"88a8a02ac7fffff",144,313,457
"165",1970-01-01 01:00:00,"88a8a02ae3fffff",33,60,93
"166",1970-01-01 01:00:00,"88a8a02aebfffff",33,60,93
"167",1970-01-01 01:00:00,"88a8a03987fffff",51,150,201
"168",1970-01-01 01:00:00,"88a8a03997fffff",51,150,201
"169",1970-01-01 01:00:00,"88a8a039a1fffff",51,150,201
"170",1970-01-01 01:00:00,"88a8a039abfffff",171,356,527
"171",1970-01-01 01:00:00,"88a8a039adfffff",51,150,201
"172",1970-01-01 01:00:00,"88a8a039b9fffff",120,206,326
"173",1970-01-01 01:00:00,"88a8a039bbfffff",111,253,364
"174",1970-01-01 01:00:00,"88a8a039bdfffff",120,206,326
"175",1970-01-01 01:00:00,"88a8a06085fffff",273,656,929
"176",1970-01-01 01:00:00,"88a8a0608dfffff",273,656,929
"177",1970-01-01 01:00:00,"88a8a060a3fffff",162,403,565
"178",1970-01-01 01:00:00,"88a8a060abfffff",213,553,766
"179",1970-01-01 01:00:00,"88a8a060c3fffff",213,553,766
"180",1970-01-01 01:00:00,"88a8a060c7fffff",213,553,766
"181",1970-01-01 01:00:00,"88a8a060cbfffff",210,499,709
"182",1970-01-01 01:00:00,"88a8a06193fffff",162,403,565
"183",1970-01-01 01:00:00,"88a8a06197fffff",60,103,163
"184",1970-01-01 01:00:00,"88a8a0619bfffff",51,150,201
"185",1970-01-01 01:00:00,"88a8a061a1fffff",210,499,709
"186",1970-01-01 01:00:00,"88a8a061a3fffff",210,499,709
"187",1970-01-01 01:00:00,"88a8a061a5fffff",309,745,1054
"188",1970-01-01 01:00:00,"88a8a061b1fffff",102,300,402
"189",1970-01-01 01:00:00,"88a8a061b3fffff",162,403,565
"190",1970-01-01 01:00:00,"88a8a061b5fffff",162,403,565
"191",1970-01-01 01:00:00,"88a8a061b7fffff",60,103,163
"192",1970-01-01 01:00:00,"88a8a06281fffff",51,150,201
"193",1970-01-01 01:00:00,"88a8a06283fffff",111,253,364
"194",1970-01-01 01:00:00,"88a8a06287fffff",159,349,508
"195",1970-01-01 01:00:00,"88a8a06289fffff",111,253,364
"196",1970-01-01 01:00:00,"88a8a06293fffff",0,0,0
"197",1970-01-01 01:00:00,"88a8a06299fffff",0,0,0
"198",1970-01-01 01:00:00,"88a8a0629bfffff",0,0,0
"199",1970-01-01 01:00:00,"88a8a062b5fffff",159,349,508
"200",1970-01-01 01:00:00,"88a8a062bdfffff",159,349,508
"201",1970-01-01 01:00:00,"88a8a062c3fffff",111,253,364
"202",1970-01-01 01:00:00,"88a8a062cbfffff",171,356,527
"203",1970-01-01 01:00:00,"88a8a062d3fffff",0,0,0
"204",1970-01-01 01:00:00,"88a8a062d9fffff",0,0,0
"205",1970-01-01 01:00:00,"88a8a06541fffff",60,103,163
"206",1970-01-01 01:00:00,"88a8a06549fffff",120,206,326
"207",1970-01-01 01:00:00,"88a8a06705fffff",60,103,163
"208",1970-01-01 01:00:00,"88a8a06707fffff",60,103,163
"209",1970-01-01 01:00:00,"88a8a0670dfffff",0,0,0
"210",1970-01-01 01:00:00,"88a8a0672bfffff",0,0,0
"211",1970-01-01 01:00:00,"88a8a06731fffff",60,103,163
"212",1970-01-01 01:00:00,"88a8a06735fffff",60,103,163
"213",1970-01-01 01:00:00,"88a8a06739fffff",60,103,163
"214",1970-01-01 01:00:00,"88a8a0676bfffff",60,103,163
"215",1970-01-01 01:00:00,"88a8a06a91fffff",159,349,508
"216",1970-01-01 01:00:00,"88a8a06a9bfffff",201,546,747
"217",1970-01-01 01:00:00,"88a8a06e49fffff",111,253,364
"218",1970-01-01 01:00:00,"88a8a06e4dfffff",111,253,364
"219",1970-01-01 01:00:00,"88a8a06e6dfffff",111,253,364
"220",1970-01-01 01:00:00,"88a8a07441fffff",180,309,489
"221",1970-01-01 01:00:00,"88a8a07445fffff",120,206,326
"222",1970-01-01 01:00:00,"88a8a07447fffff",120,206,326
"223",1970-01-01 01:00:00,"88a8a0744bfffff",180,309,489
"224",1970-01-01 01:00:00,"88a8a07461fffff",180,309,489
"225",1970-01-01 01:00:00,"88a8a07465fffff",180,309,489
"226",1970-01-01 01:00:00,"88a8a07467fffff",0,0,0
"227",1970-01-01 01:00:00,"88a8a07469fffff",0,0,0
"228",1970-01-01 01:00:00,"88a8a0746bfffff",120,206,326
"229",1970-01-01 01:00:00,"88a8a07503fffff",0,0,0
"230",1970-01-01 01:00:00,"88a8a07507fffff",180,309,489
"231",1970-01-01 01:00:00,"88a8a07515fffff",0,0,0
"232",1970-01-01 01:00:00,"88a8a0751dfffff",0,0,0
"233",1970-01-01 01:00:00,"88a8a07521fffff",228,405,633
"234",1970-01-01 01:00:00,"88a8a07525fffff",180,309,489
"235",1970-01-01 01:00:00,"88a8a0752bfffff",348,611,959
"236",1970-01-01 01:00:00,"88a8a0752dfffff",300,515,815
"237",1970-01-01 01:00:00,"88a8a07531fffff",360,618,978
"238",1970-01-01 01:00:00,"88a8a07533fffff",0,0,0
"239",1970-01-01 01:00:00,"88a8a07535fffff",171,356,527
"240",1970-01-01 01:00:00,"88a8a07537fffff",0,0,0
"241",1970-01-01 01:00:00,"88a8a07539fffff",120,206,326
"242",1970-01-01 01:00:00,"88a8a0753dfffff",159,349,508
"243",1970-01-01 01:00:00,"88a8a07543fffff",180,309,489
"244",1970-01-01 01:00:00,"88a8a07545fffff",120,206,326
"245",1970-01-01 01:00:00,"88a8a07547fffff",180,309,489
"246",1970-01-01 01:00:00,"88a8a07553fffff",0,0,0
"247",1970-01-01 01:00:00,"88a8a07557fffff",0,0,0
"248",1970-01-01 01:00:00,"88a8a07559fffff",180,309,489
"249",1970-01-01 01:00:00,"88a8a0755bfffff",0,0,0
"250",1970-01-01 01:00:00,"88a8a0755dfffff",180,309,489
"251",1970-01-01 01:00:00,"88a8a07561fffff",228,405,633
"252",1970-01-01 01:00:00,"88a8a07567fffff",288,508,796
"253",1970-01-01 01:00:00,"88a8a07569fffff",180,309,489
"254",1970-01-01 01:00:00,"88a8a0756bfffff",60,103,163
"255",1970-01-01 01:00:00,"88a8a0756dfffff",351,665,1016
"256",1970-01-01 01:00:00,"88a8a07633fffff",120,206,326
"257",1970-01-01 01:00:00,"88a8a07637fffff",180,309,489
"258",1970-01-01 01:00:00,"88a8a076c7fffff",60,103,163
"259",1970-01-01 01:00:00,"88a8a076d1fffff",171,356,527
"260",1970-01-01 01:00:00,"88a8a076d3fffff",171,356,527
"261",1970-01-01 01:00:00,"88a8a076d5fffff",171,356,527
"262",1970-01-01 01:00:00,"88a8a076e9fffff",120,206,326
"263",1970-01-01 01:00:00,"88a8a076ebfffff",60,103,163
"264",1970-01-01 01:00:00,"88a8a076edfffff",120,206,326
"265",1970-01-01 01:30:00,"88a8a02801fffff",84,210,294
"266",1970-01-01 01:30:00,"88a8a02809fffff",84,210,294
"267",1970-01-01 01:30:00,"88a8a0280bfffff",51,150,201
"268",1970-01-01 01:30:00,"88a8a02853fffff",51,150,201
"269",1970-01-01 01:30:00,"88a8a02857fffff",51,150,201
"270",1970-01-01 01:30:00,"88a8a02a11fffff",60,103,163
"271",1970-01-01 01:30:00,"88a8a02a13fffff",60,103,163
"272",1970-01-01 01:30:00,"88a8a02a19fffff",60,103,163
"273",1970-01-01 01:30:00,"88a8a02a57fffff",60,103,163
"274",1970-01-01 01:30:00,"88a8a02a89fffff",120,206,326
"275",1970-01-01 01:30:00,"88a8a02a8bfffff",120,206,326
"276",1970-01-01 01:30:00,"88a8a02a9dfffff",120,206,326
"277",1970-01-01 01:30:00,"88a8a02aadfffff",51,150,201
"278",1970-01-01 01:30:00,"88a8a02ac5fffff",120,206,326
"279",1970-01-01 01:30:00,"88a8a02ac7fffff",120,206,326
"280",1970-01-01 01:30:00,"88a8a02ae3fffff",51,150,201
"281",1970-01-01 01:30:00,"88a8a02ae7fffff",51,150,201
"282",1970-01-01 01:30:00,"88a8a02aebfffff",51,150,201
"283",1970-01-01 01:30:00,"88a8a06085fffff",48,96,144
"284",1970-01-01 01:30:00,"88a8a0608dfffff",168,302,470
"285",1970-01-01 01:30:00,"88a8a060a3fffff",48,96,144
"286",1970-01-01 01:30:00,"88a8a060abfffff",48,96,144
"287",1970-01-01 01:30:00,"88a8a060c3fffff",108,199,307
"288",1970-01-01 01:30:00,"88a8a060c7fffff",108,199,307
"289",1970-01-01 01:30:00,"88a8a060cbfffff",120,206,326
"290",1970-01-01 01:30:00,"88a8a06193fffff",159,349,508
"291",1970-01-01 01:30:00,"88a8a06197fffff",51,150,201
"292",1970-01-01 01:30:00,"88a8a0619bfffff",51,150,201
"293",1970-01-01 01:30:00,"88a8a061a1fffff",99,246,345
"294",1970-01-01 01:30:00,"88a8a061a3fffff",99,246,345
"295",1970-01-01 01:30:00,"88a8a061a5fffff",150,396,546
"296",1970-01-01 01:30:00,"88a8a061b1fffff",48,96,144
"297",1970-01-01 01:30:00,"88a8a061b3fffff",99,246,345
"298",1970-01-01 01:30:00,"88a8a061b5fffff",99,246,345
"299",1970-01-01 01:30:00,"88a8a061b7fffff",51,150,201
"300",1970-01-01 01:30:00,"88a8a06281fffff",60,103,163
"301",1970-01-01 01:30:00,"88a8a06283fffff",120,206,326
"302",1970-01-01 01:30:00,"88a8a06287fffff",120,206,326
"303",1970-01-01 01:30:00,"88a8a06289fffff",120,206,326
"304",1970-01-01 01:30:00,"88a8a0628bfffff",60,103,163
"305",1970-01-01 01:30:00,"88a8a062b5fffff",120,206,326
"306",1970-01-01 01:30:00,"88a8a062bdfffff",180,309,489
"307",1970-01-01 01:30:00,"88a8a062c1fffff",60,103,163
"308",1970-01-01 01:30:00,"88a8a062c3fffff",120,206,326
"309",1970-01-01 01:30:00,"88a8a062cbfffff",120,206,326
"310",1970-01-01 01:30:00,"88a8a062d3fffff",0,0,0
"311",1970-01-01 01:30:00,"88a8a06541fffff",0,0,0
"312",1970-01-01 01:30:00,"88a8a06549fffff",0,0,0
"313",1970-01-01 01:30:00,"88a8a06707fffff",0,0,0
"314",1970-01-01 01:30:00,"88a8a0670dfffff",0,0,0
"315",1970-01-01 01:30:00,"88a8a0672bfffff",0,0,0
"316",1970-01-01 01:30:00,"88a8a06731fffff",0,0,0
"317",1970-01-01 01:30:00,"88a8a06735fffff",0,0,0
"318",1970-01-01 01:30:00,"88a8a06739fffff",0,0,0
"319",1970-01-01 01:30:00,"88a8a0676bfffff",0,0,0
"320",1970-01-01 01:30:00,"88a8a06a91fffff",102,300,402
"321",1970-01-01 01:30:00,"88a8a06a9bfffff",51,150,201
"322",1970-01-01 01:30:00,"88a8a06e45fffff",48,96,144
"323",1970-01-01 01:30:00,"88a8a06e49fffff",99,246,345
"324",1970-01-01 01:30:00,"88a8a06e4dfffff",99,246,345
"325",1970-01-01 01:30:00,"88a8a06e69fffff",99,246,345
"326",1970-01-01 01:30:00,"88a8a06e6dfffff",99,246,345
"327",1970-01-01 01:30:00,"88a8a07441fffff",111,253,364
"328",1970-01-01 01:30:00,"88a8a07445fffff",60,103,163
"329",1970-01-01 01:30:00,"88a8a07447fffff",171,356,527
"330",1970-01-01 01:30:00,"88a8a0744bfffff",60,103,163
"331",1970-01-01 01:30:00,"88a8a07461fffff",231,459,690
"332",1970-01-01 01:30:00,"88a8a07465fffff",111,253,364
"333",1970-01-01 01:30:00,"88a8a07467fffff",120,206,326
"334",1970-01-01 01:30:00,"88a8a07469fffff",60,103,163
"335",1970-01-01 01:30:00,"88a8a0746bfffff",171,356,527
"336",1970-01-01 01:30:00,"88a8a07507fffff",120,206,326
"337",1970-01-01 01:30:00,"88a8a07515fffff",120,206,326
"338",1970-01-01 01:30:00,"88a8a0751dfffff",60,103,163
"339",1970-01-01 01:30:00,"88a8a07521fffff",180,309,489
"340",1970-01-01 01:30:00,"88a8a07525fffff",180,309,489
"341",1970-01-01 01:30:00,"88a8a0752bfffff",180,309,489
"342",1970-01-01 01:30:00,"88a8a0752dfffff",180,309,489
"343",1970-01-01 01:30:00,"88a8a07531fffff",420,721,1141
"344",1970-01-01 01:30:00,"88a8a07533fffff",0,0,0
"345",1970-01-01 01:30:00,"88a8a07535fffff",120,206,326
"346",1970-01-01 01:30:00,"88a8a07537fffff",0,0,0
"347",1970-01-01 01:30:00,"88a8a07539fffff",300,515,815
"348",1970-01-01 01:30:00,"88a8a0753dfffff",120,206,326
"349",1970-01-01 01:30:00,"88a8a07543fffff",111,253,364
"350",1970-01-01 01:30:00,"88a8a07545fffff",111,253,364
"351",1970-01-01 01:30:00,"88a8a07547fffff",111,253,364
"352",1970-01-01 01:30:00,"88a8a07553fffff",120,206,326
"353",1970-01-01 01:30:00,"88a8a07557fffff",60,103,163
"354",1970-01-01 01:30:00,"88a8a07559fffff",111,253,364
"355",1970-01-01 01:30:00,"88a8a0755bfffff",120,206,326
"356",1970-01-01 01:30:00,"88a8a0755dfffff",111,253,364
"357",1970-01-01 01:30:00,"88a8a07561fffff",180,309,489
"358",1970-01-01 01:30:00,"88a8a07567fffff",180,309,489
"359",1970-01-01 01:30:00,"88a8a07569fffff",111,253,364
"360",1970-01-01 01:30:00,"88a8a0756bfffff",111,253,364
"361",1970-01-01 01:30:00,"88a8a0756dfffff",231,459,690
"362",1970-01-01 02:00:00,"88a8a02809fffff",0,0,0
"363",1970-01-01 02:00:00,"88a8a02a05fffff",120,206,326
"364",1970-01-01 02:00:00,"88a8a02a0bfffff",60,103,163
"365",1970-01-01 02:00:00,"88a8a02a0dfffff",60,103,163
"366",1970-01-01 02:00:00,"88a8a02a57fffff",60,103,163
"367",1970-01-01 02:00:00,"88a8a02a61fffff",60,103,163
"368",1970-01-01 02:00:00,"88a8a02a63fffff",120,206,326
"369",1970-01-01 02:00:00,"88a8a02a69fffff",120,206,326
"370",1970-01-01 02:00:00,"88a8a02a89fffff",60,103,163
"371",1970-01-01 02:00:00,"88a8a02a8bfffff",60,103,163
"372",1970-01-01 02:00:00,"88a8a02ac5fffff",60,103,163
"373",1970-01-01 02:00:00,"88a8a02ac7fffff",60,103,163
"374",1970-01-01 02:00:00,"88a8a03995fffff",60,103,163
"375",1970-01-01 02:00:00,"88a8a03997fffff",120,206,326
"376",1970-01-01 02:00:00,"88a8a039a1fffff",60,103,163
"377",1970-01-01 02:00:00,"88a8a039abfffff",120,206,326
"378",1970-01-01 02:00:00,"88a8a039adfffff",171,356,527
"379",1970-01-01 02:00:00,"88a8a039b9fffff",60,103,163
"380",1970-01-01 02:00:00,"88a8a039bbfffff",120,206,326
"381",1970-01-01 02:00:00,"88a8a06085fffff",60,103,163
"382",1970-01-01 02:00:00,"88a8a0608dfffff",120,206,326
"383",1970-01-01 02:00:00,"88a8a060a3fffff",60,103,163
"384",1970-01-01 02:00:00,"88a8a060abfffff",60,103,163
"385",1970-01-01 02:00:00,"88a8a060c1fffff",60,103,163
"386",1970-01-01 02:00:00,"88a8a060c3fffff",60,103,163
"387",1970-01-01 02:00:00,"88a8a060c7fffff",60,103,163
"388",1970-01-01 02:00:00,"88a8a060cbfffff",60,103,163
"389",1970-01-01 02:00:00,"88a8a06193fffff",60,103,163
"390",1970-01-01 02:00:00,"88a8a061a1fffff",60,103,163
"391",1970-01-01 02:00:00,"88a8a061a3fffff",60,103,163
"392",1970-01-01 02:00:00,"88a8a061a5fffff",171,356,527
"393",1970-01-01 02:00:00,"88a8a061b3fffff",60,103,163
"394",1970-01-01 02:00:00,"88a8a061b5fffff",60,103,163
"395",1970-01-01 02:00:00,"88a8a061b7fffff",60,103,163
"396",1970-01-01 02:00:00,"88a8a06283fffff",60,103,163
"397",1970-01-01 02:00:00,"88a8a06287fffff",60,103,163
"398",1970-01-01 02:00:00,"88a8a06289fffff",60,103,163
"399",1970-01-01 02:00:00,"88a8a06293fffff",0,0,0
"400",1970-01-01 02:00:00,"88a8a0629bfffff",0,0,0
"401",1970-01-01 02:00:00,"88a8a062b5fffff",60,103,163
"402",1970-01-01 02:00:00,"88a8a062bdfffff",60,103,163
"403",1970-01-01 02:00:00,"88a8a062c3fffff",60,103,163
"404",1970-01-01 02:00:00,"88a8a062cbfffff",60,103,163
"405",1970-01-01 02:00:00,"88a8a062d3fffff",0,0,0
"406",1970-01-01 02:00:00,"88a8a062d9fffff",0,0,0
"407",1970-01-01 02:00:00,"88a8a06705fffff",0,0,0
"408",1970-01-01 02:00:00,"88a8a06707fffff",0,0,0
"409",1970-01-01 02:00:00,"88a8a0670dfffff",0,0,0
"410",1970-01-01 02:00:00,"88a8a0672bfffff",0,0,0
"411",1970-01-01 02:00:00,"88a8a06731fffff",0,0,0
"412",1970-01-01 02:00:00,"88a8a06739fffff",0,0,0
"413",1970-01-01 02:00:00,"88a8a0676bfffff",0,0,0
"414",1970-01-01 02:00:00,"88a8a06a91fffff",102,185,287
"415",1970-01-01 02:00:00,"88a8a06a9bfffff",213,438,651
"416",1970-01-01 02:00:00,"88a8a06e49fffff",60,103,163
"417",1970-01-01 02:00:00,"88a8a06e4dfffff",60,103,163
"418",1970-01-01 02:00:00,"88a8a06e69fffff",60,103,163
"419",1970-01-01 02:00:00,"88a8a06e6dfffff",60,103,163
"420",1970-01-01 02:00:00,"88a8a07441fffff",171,356,527
"421",1970-01-01 02:00:00,"88a8a07445fffff",111,253,364
"422",1970-01-01 02:00:00,"88a8a0744bfffff",111,253,364
"423",1970-01-01 02:00:00,"88a8a07461fffff",111,253,364
"424",1970-01-01 02:00:00,"88a8a07465fffff",51,150,201
"425",1970-01-01 02:00:00,"88a8a07467fffff",60,103,163
"426",1970-01-01 02:00:00,"88a8a07469fffff",60,103,163
"427",1970-01-01 02:00:00,"88a8a0746bfffff",111,253,364
"428",1970-01-01 02:00:00,"88a8a07515fffff",60,103,163
"429",1970-01-01 02:00:00,"88a8a0751dfffff",60,103,163
"430",1970-01-01 02:00:00,"88a8a07521fffff",60,103,163
"431",1970-01-01 02:00:00,"88a8a07525fffff",60,103,163
"432",1970-01-01 02:00:00,"88a8a0752bfffff",60,103,163
"433",1970-01-01 02:00:00,"88a8a0752dfffff",60,103,163
"434",1970-01-01 02:00:00,"88a8a07531fffff",60,103,163
"435",1970-01-01 02:00:00,"88a8a07533fffff",0,0,0
"436",1970-01-01 02:00:00,"88a8a07535fffff",60,103,163
"437",1970-01-01 02:00:00,"88a8a07537fffff",0,0,0
"438",1970-01-01 02:00:00,"88a8a07539fffff",120,206,326
"439",1970-01-01 02:00:00,"88a8a0753bfffff",60,103,163
"440",1970-01-01 02:00:00,"88a8a07543fffff",51,150,201
"441",1970-01-01 02:00:00,"88a8a07547fffff",51,150,201
"442",1970-01-01 02:00:00,"88a8a07553fffff",60,103,163
"443",1970-01-01 02:00:00,"88a8a07557fffff",60,103,163
"444",1970-01-01 02:00:00,"88a8a07559fffff",51,150,201
"445",1970-01-01 02:00:00,"88a8a0755bfffff",60,103,163
"446",1970-01-01 02:00:00,"88a8a0755dfffff",51,150,201
"447",1970-01-01 02:00:00,"88a8a07561fffff",60,103,163
"448",1970-01-01 02:00:00,"88a8a07567fffff",60,103,163
"449",1970-01-01 02:00:00,"88a8a07569fffff",51,150,201
"450",1970-01-01 02:00:00,"88a8a0756bfffff",51,150,201
"451",1970-01-01 02:00:00,"88a8a0756dfffff",0,0,0
"452",1970-01-01 02:00:00,"88a8a07633fffff",111,253,364
"453",1970-01-01 02:00:00,"88a8a07637fffff",111,253,364
"454",1970-01-01 02:00:00,"88a8a076c7fffff",111,253,364
"455",1970-01-01 02:00:00,"88a8a076d1fffff",51,150,201
"456",1970-01-01 02:00:00,"88a8a076d3fffff",171,356,527
"457",1970-01-01 02:00:00,"88a8a076d5fffff",120,206,326
"458",1970-01-01 02:00:00,"88a8a076e9fffff",111,253,364
"459",1970-01-01 02:00:00,"88a8a076ebfffff",51,150,201
"460",1970-01-01 02:00:00,"88a8a076edfffff",111,253,364
"461",1970-01-01 02:30:00,"88a8a02809fffff",0,0,0
"462",1970-01-01 02:30:00,"88a8a02a01fffff",111,253,364
"463",1970-01-01 02:30:00,"88a8a02a05fffff",51,150,201
"464",1970-01-01 02:30:00,"88a8a02a0bfffff",60,103,163
"465",1970-01-01 02:30:00,"88a8a02a11fffff",60,103,163
"466",1970-01-01 02:30:00,"88a8a02a13fffff",60,103,163
"467",1970-01-01 02:30:00,"88a8a02a19fffff",60,103,163
"468",1970-01-01 02:30:00,"88a8a02a69fffff",51,150,201
"469",1970-01-01 02:30:00,"88a8a02a6bfffff",51,150,201
"470",1970-01-01 02:30:00,"88a8a02a89fffff",120,206,326
"471",1970-01-01 02:30:00,"88a8a02a8bfffff",120,206,326
"472",1970-01-01 02:30:00,"88a8a02a9dfffff",111,253,364
"473",1970-01-01 02:30:00,"88a8a02ac5fffff",60,103,163
"474",1970-01-01 02:30:00,"88a8a02ac7fffff",120,206,326
"475",1970-01-01 02:30:00,"88a8a03987fffff",51,150,201
"476",1970-01-01 02:30:00,"88a8a039a1fffff",51,150,201
"477",1970-01-01 02:30:00,"88a8a039abfffff",51,150,201
"478",1970-01-01 02:30:00,"88a8a039b9fffff",51,150,201
"479",1970-01-01 02:30:00,"88a8a06085fffff",120,206,326
"480",1970-01-01 02:30:00,"88a8a060a3fffff",120,206,326
"481",1970-01-01 02:30:00,"88a8a060a7fffff",60,103,163
"482",1970-01-01 02:30:00,"88a8a060abfffff",120,206,326
"483",1970-01-01 02:30:00,"88a8a06193fffff",120,206,326
"484",1970-01-01 02:30:00,"88a8a06197fffff",60,103,163
"485",1970-01-01 02:30:00,"88a8a0619bfffff",60,103,163
"486",1970-01-01 02:30:00,"88a8a061a1fffff",120,206,326
"487",1970-01-01 02:30:00,"88a8a061a3fffff",120,206,326
"488",1970-01-01 02:30:00,"88a8a061a5fffff",144,267,411
"489",1970-01-01 02:30:00,"88a8a061b3fffff",120,206,326
"490",1970-01-01 02:30:00,"88a8a061b5fffff",120,206,326
"491",1970-01-01 02:30:00,"88a8a061b7fffff",120,206,326
"492",1970-01-01 02:30:00,"88a8a06289fffff",60,103,163
"493",1970-01-01 02:30:00,"88a8a0628bfffff",60,103,163
"494",1970-01-01 02:30:00,"88a8a06299fffff",0,0,0
"495",1970-01-01 02:30:00,"88a8a0629bfffff",0,0,0
"496",1970-01-01 02:30:00,"88a8a062bdfffff",60,103,163
"497",1970-01-01 02:30:00,"88a8a06705fffff",0,0,0
"498",1970-01-01 02:30:00,"88a8a06707fffff",0,0,0
"499",1970-01-01 02:30:00,"88a8a0670dfffff",0,0,0
"500",1970-01-01 02:30:00,"88a8a0672bfffff",0,0,0
"501",1970-01-01 02:30:00,"88a8a06731fffff",0,0,0
"502",1970-01-01 02:30:00,"88a8a06735fffff",0,0,0
"503",1970-01-01 02:30:00,"88a8a06739fffff",0,0,0
"504",1970-01-01 02:30:00,"88a8a0676bfffff",0,0,0
"505",1970-01-01 02:30:00,"88a8a06a91fffff",102,185,287
"506",1970-01-01 02:30:00,"88a8a06a9bfffff",288,534,822
"507",1970-01-01 02:30:00,"88a8a06e49fffff",60,103,163
"508",1970-01-01 02:30:00,"88a8a06e4dfffff",60,103,163
"509",1970-01-01 02:30:00,"88a8a06e6dfffff",120,206,326
"510",1970-01-01 02:30:00,"88a8a07441fffff",60,103,163
"511",1970-01-01 02:30:00,"88a8a07445fffff",60,103,163
"512",1970-01-01 02:30:00,"88a8a07447fffff",0,0,0
"513",1970-01-01 02:30:00,"88a8a0744bfffff",0,0,0
"514",1970-01-01 02:30:00,"88a8a07461fffff",120,206,326
"515",1970-01-01 02:30:00,"88a8a07465fffff",60,103,163
"516",1970-01-01 02:30:00,"88a8a07467fffff",60,103,163
"517",1970-01-01 02:30:00,"88a8a0746bfffff",60,103,163
"518",1970-01-01 02:30:00,"88a8a07507fffff",60,103,163
"519",1970-01-01 02:30:00,"88a8a07515fffff",60,103,163
"520",1970-01-01 02:30:00,"88a8a0751dfffff",60,103,163
"521",1970-01-01 02:30:00,"88a8a07521fffff",60,103,163
"522",1970-01-01 02:30:00,"88a8a0752bfffff",60,103,163
"523",1970-01-01 02:30:00,"88a8a0752dfffff",60,103,163
"524",1970-01-01 02:30:00,"88a8a07531fffff",120,206,326
"525",1970-01-01 02:30:00,"88a8a07537fffff",0,0,0
"526",1970-01-01 02:30:00,"88a8a07539fffff",180,309,489
"527",1970-01-01 02:30:00,"88a8a07553fffff",60,103,163
"528",1970-01-01 02:30:00,"88a8a07557fffff",0,0,0
"529",1970-01-01 02:30:00,"88a8a0755bfffff",60,103,163
"530",1970-01-01 02:30:00,"88a8a07567fffff",60,103,163
"531",1970-01-01 02:30:00,"88a8a0756dfffff",60,103,163
"532",1970-01-01 02:30:00,"88a8a07633fffff",0,0,0
"533",1970-01-01 02:30:00,"88a8a07637fffff",0,0,0
"534",1970-01-01 02:30:00,"88a8a076e9fffff",0,0,0
"535",1970-01-01 02:30:00,"88a8a076ebfffff",0,0,0
"536",1970-01-01 02:30:00,"88a8a076edfffff",0,0,0
"537",1970-01-01 03:00:00,"88a8a02801fffff",102,300,402
"538",1970-01-01 03:00:00,"88a8a02805fffff",51,150,201
"539",1970-01-01 03:00:00,"88a8a02809fffff",0,0,0
"540",1970-01-01 03:00:00,"88a8a0280bfffff",153,450,603
"541",1970-01-01 03:00:00,"88a8a02853fffff",102,300,402
"542",1970-01-01 03:00:00,"88a8a02857fffff",102,300,402
"543",1970-01-01 03:00:00,"88a8a02a01fffff",60,103,163
"544",1970-01-01 03:00:00,"88a8a02a05fffff",60,103,163
"545",1970-01-01 03:00:00,"88a8a02a11fffff",60,103,163
"546",1970-01-01 03:00:00,"88a8a02a13fffff",60,103,163
"547",1970-01-01 03:00:00,"88a8a02a19fffff",60,103,163
"548",1970-01-01 03:00:00,"88a8a02a57fffff",60,103,163
"549",1970-01-01 03:00:00,"88a8a02a63fffff",60,103,163
"550",1970-01-01 03:00:00,"88a8a02a69fffff",60,103,163
"551",1970-01-01 03:00:00,"88a8a02a89fffff",51,150,201
"552",1970-01-01 03:00:00,"88a8a02a8bfffff",51,150,201
"553",1970-01-01 03:00:00,"88a8a02aa9fffff",51,150,201
"554",1970-01-01 03:00:00,"88a8a02aadfffff",102,300,402
"555",1970-01-01 03:00:00,"88a8a02ac5fffff",60,103,163
"556",1970-01-01 03:00:00,"88a8a02ac7fffff",51,150,201
"557",1970-01-01 03:00:00,"88a8a02ae3fffff",102,300,402
"558",1970-01-01 03:00:00,"88a8a02ae7fffff",51,150,201
"559",1970-01-01 03:00:00,"88a8a02aebfffff",51,150,201
"560",1970-01-01 03:00:00,"88a8a03987fffff",60,103,163
"561",1970-01-01 03:00:00,"88a8a03995fffff",60,103,163
"562",1970-01-01 03:00:00,"88a8a03997fffff",60,103,163
"563",1970-01-01 03:00:00,"88a8a039a1fffff",60,103,163
"564",1970-01-01 03:00:00,"88a8a039abfffff",60,103,163
"565",1970-01-01 03:00:00,"88a8a039adfffff",60,103,163
"566",1970-01-01 03:00:00,"88a8a039b9fffff",60,103,163
"567",1970-01-01 03:00:00,"88a8a039bbfffff",60,103,163
"568",1970-01-01 03:00:00,"88a8a06085fffff",60,103,163
"569",1970-01-01 03:00:00,"88a8a0608dfffff",180,309,489
"570",1970-01-01 03:00:00,"88a8a060a3fffff",60,103,163
"571",1970-01-01 03:00:00,"88a8a060c3fffff",120,206,326
"572",1970-01-01 03:00:00,"88a8a060c7fffff",120,206,326
"573",1970-01-01 03:00:00,"88a8a060cbfffff",120,206,326
"574",1970-01-01 03:00:00,"88a8a06193fffff",60,103,163
"575",1970-01-01 03:00:00,"88a8a061a1fffff",60,103,163
"576",1970-01-01 03:00:00,"88a8a061a3fffff",60,103,163
"577",1970-01-01 03:00:00,"88a8a061a5fffff",60,103,163
"578",1970-01-01 03:00:00,"88a8a061b3fffff",60,103,163
"579",1970-01-01 03:00:00,"88a8a061b5fffff",60,103,163
"580",1970-01-01 03:00:00,"88a8a061b7fffff",60,103,163
"581",1970-01-01 03:00:00,"88a8a06281fffff",60,103,163
"582",1970-01-01 03:00:00,"88a8a06283fffff",60,103,163
"583",1970-01-01 03:00:00,"88a8a06287fffff",60,103,163
"584",1970-01-01 03:00:00,"88a8a06289fffff",60,103,163
"585",1970-01-01 03:00:00,"88a8a062b5fffff",120,206,326
"586",1970-01-01 03:00:00,"88a8a062bdfffff",60,103,163
"587",1970-01-01 03:00:00,"88a8a062c1fffff",60,103,163
"588",1970-01-01 03:00:00,"88a8a062c3fffff",60,103,163
"589",1970-01-01 03:00:00,"88a8a062cbfffff",60,103,163
"590",1970-01-01 03:00:00,"88a8a06a9bfffff",60,103,163
"591",1970-01-01 03:00:00,"88a8a06e6dfffff",60,103,163
"592",1970-01-01 03:00:00,"88a8a07441fffff",60,103,163
"593",1970-01-01 03:00:00,"88a8a07445fffff",0,0,0
"594",1970-01-01 03:00:00,"88a8a07447fffff",60,103,163
"595",1970-01-01 03:00:00,"88a8a0744bfffff",60,103,163
"596",1970-01-01 03:00:00,"88a8a07461fffff",120,206,326
"597",1970-01-01 03:00:00,"88a8a0746bfffff",120,206,326
"598",1970-01-01 03:00:00,"88a8a07507fffff",60,103,163
"599",1970-01-01 03:00:00,"88a8a07515fffff",120,206,326
"600",1970-01-01 03:00:00,"88a8a0751dfffff",120,206,326
"601",1970-01-01 03:00:00,"88a8a07521fffff",0,0,0
"602",1970-01-01 03:00:00,"88a8a07531fffff",180,309,489
"603",1970-01-01 03:00:00,"88a8a07533fffff",0,0,0
"604",1970-01-01 03:00:00,"88a8a07535fffff",60,103,163
"605",1970-01-01 03:00:00,"88a8a07537fffff",0,0,0
"606",1970-01-01 03:00:00,"88a8a07539fffff",240,412,652
"607",1970-01-01 03:00:00,"88a8a0753bfffff",0,0,0
"608",1970-01-01 03:00:00,"88a8a0753dfffff",60,103,163
"609",1970-01-01 03:00:00,"88a8a07553fffff",120,206,326
"610",1970-01-01 03:00:00,"88a8a07557fffff",60,103,163
"611",1970-01-01 03:00:00,"88a8a0755bfffff",120,206,326
"612",1970-01-01 03:00:00,"88a8a0756dfffff",0,0,0
"613",1970-01-01 03:00:00,"88a8a07633fffff",60,103,163
"614",1970-01-01 03:00:00,"88a8a07637fffff",60,103,163
"615",1970-01-01 03:00:00,"88a8a076c7fffff",60,103,163
"616",1970-01-01 03:00:00,"88a8a076d1fffff",60,103,163
"617",1970-01-01 03:00:00,"88a8a076d3fffff",60,103,163
"618",1970-01-01 03:00:00,"88a8a076d5fffff",60,103,163
"619",1970-01-01 03:00:00,"88a8a076e9fffff",60,103,163
"620",1970-01-01 03:00:00,"88a8a076ebfffff",60,103,163
"621",1970-01-01 03:00:00,"88a8a076edfffff",60,103,163
"622",1970-01-01 03:30:00,"88a8a02801fffff",190,508,698
"623",1970-01-01 03:30:00,"88a8a02809fffff",0,0,0
"624",1970-01-01 03:30:00,"88a8a0280bfffff",206,599,805
"625",1970-01-01 03:30:00,"88a8a02829fffff",51,150,201
"626",1970-01-01 03:30:00,"88a8a0282dfffff",51,150,201
"627",1970-01-01 03:30:00,"88a8a02853fffff",204,600,804
"628",1970-01-01 03:30:00,"88a8a02857fffff",257,749,1006
"629",1970-01-01 03:30:00,"88a8a0291dfffff",51,150,201
"630",1970-01-01 03:30:00,"88a8a02953fffff",51,150,201
"631",1970-01-01 03:30:00,"88a8a02957fffff",51,150,201
"632",1970-01-01 03:30:00,"88a8a02a11fffff",102,300,402
"633",1970-01-01 03:30:00,"88a8a02a13fffff",102,300,402
"634",1970-01-01 03:30:00,"88a8a02a19fffff",51,150,201
"635",1970-01-01 03:30:00,"88a8a02a57fffff",51,150,201
"636",1970-01-01 03:30:00,"88a8a02a89fffff",255,750,1005
"637",1970-01-01 03:30:00,"88a8a02a8bfffff",153,450,603
"638",1970-01-01 03:30:00,"88a8a02a9dfffff",153,450,603
"639",1970-01-01 03:30:00,"88a8a02aa9fffff",51,150,201
"640",1970-01-01 03:30:00,"88a8a02aadfffff",257,749,1006
"641",1970-01-01 03:30:00,"88a8a02ac5fffff",102,300,402
"642",1970-01-01 03:30:00,"88a8a02ac7fffff",359,1049,1408
"643",1970-01-01 03:30:00,"88a8a02ae3fffff",257,749,1006
"644",1970-01-01 03:30:00,"88a8a02ae7fffff",102,300,402
"645",1970-01-01 03:30:00,"88a8a02aebfffff",308,899,1207
"646",1970-01-01 03:30:00,"88a8a03987fffff",60,103,163
"647",1970-01-01 03:30:00,"88a8a03995fffff",60,103,163
"648",1970-01-01 03:30:00,"88a8a03997fffff",60,103,163
"649",1970-01-01 03:30:00,"88a8a039a1fffff",180,309,489
"650",1970-01-01 03:30:00,"88a8a039abfffff",240,412,652
"651",1970-01-01 03:30:00,"88a8a039adfffff",240,412,652
"652",1970-01-01 03:30:00,"88a8a039b9fffff",240,412,652
"653",1970-01-01 03:30:00,"88a8a039bbfffff",240,412,652
"654",1970-01-01 03:30:00,"88a8a039bdfffff",60,103,163
"655",1970-01-01 03:30:00,"88a8a061a1fffff",51,150,201
"656",1970-01-01 03:30:00,"88a8a061a3fffff",51,150,201
"657",1970-01-01 03:30:00,"88a8a061a5fffff",0,0,0
"658",1970-01-01 03:30:00,"88a8a061b5fffff",51,150,201
"659",1970-01-01 03:30:00,"88a8a0629bfffff",0,0,0
"660",1970-01-01 03:30:00,"88a8a062d1fffff",0,0,0
"661",1970-01-01 03:30:00,"88a8a062d9fffff",0,0,0
"662",1970-01-01 03:30:00,"88a8a06a91fffff",102,300,402
"663",1970-01-01 03:30:00,"88a8a06a9bfffff",153,450,603
"664",1970-01-01 03:30:00,"88a8a07441fffff",120,206,326
"665",1970-01-01 03:30:00,"88a8a07447fffff",120,206,326
"666",1970-01-01 03:30:00,"88a8a0744bfffff",120,206,326
"667",1970-01-01 03:30:00,"88a8a07461fffff",120,206,326
"668",1970-01-01 03:30:00,"88a8a07467fffff",120,206,326
"669",1970-01-01 03:30:00,"88a8a07469fffff",60,103,163
"670",1970-01-01 03:30:00,"88a8a0746bfffff",120,206,326
"671",1970-01-01 03:30:00,"88a8a07503fffff",60,103,163
"672",1970-01-01 03:30:00,"88a8a07507fffff",180,309,489
"673",1970-01-01 03:30:00,"88a8a07515fffff",120,206,326
"674",1970-01-01 03:30:00,"88a8a0751dfffff",180,309,489
"675",1970-01-01 03:30:00,"88a8a07521fffff",60,103,163
"676",1970-01-01 03:30:00,"88a8a07525fffff",60,103,163
"677",1970-01-01 03:30:00,"88a8a0752bfffff",60,103,163
"678",1970-01-01 03:30:00,"88a8a0752dfffff",60,103,163
"679",1970-01-01 03:30:00,"88a8a07531fffff",120,206,326
"680",1970-01-01 03:30:00,"88a8a07533fffff",0,0,0
"681",1970-01-01 03:30:00,"88a8a07537fffff",0,0,0
"682",1970-01-01 03:30:00,"88a8a07539fffff",420,721,1141
"683",1970-01-01 03:30:00,"88a8a0753dfffff",120,206,326
"684",1970-01-01 03:30:00,"88a8a07553fffff",180,309,489
"685",1970-01-01 03:30:00,"88a8a07557fffff",120,206,326
"686",1970-01-01 03:30:00,"88a8a0755bfffff",120,206,326
"687",1970-01-01 03:30:00,"88a8a07561fffff",60,103,163
"688",1970-01-01 03:30:00,"88a8a07567fffff",60,103,163
"689",1970-01-01 03:30:00,"88a8a0756dfffff",60,103,163
"690",1970-01-01 03:30:00,"88a8a07633fffff",120,206,326
"691",1970-01-01 03:30:00,"88a8a07637fffff",60,103,163
"692",1970-01-01 03:30:00,"88a8a076c7fffff",180,309,489
"693",1970-01-01 03:30:00,"88a8a076d3fffff",180,309,489
"694",1970-01-01 03:30:00,"88a8a076d5fffff",60,103,163
"695",1970-01-01 03:30:00,"88a8a076d7fffff",60,103,163
"696",1970-01-01 03:30:00,"88a8a076e9fffff",60,103,163
"697",1970-01-01 03:30:00,"88a8a076ebfffff",60,103,163
"698",1970-01-01 03:30:00,"88a8a076edfffff",60,103,163
"699",1970-01-01 04:00:00,"88a8a02801fffff",201,521,722
"700",1970-01-01 04:00:00,"88a8a02805fffff",51,150,201
"701",1970-01-01 04:00:00,"88a8a02809fffff",51,150,201
"702",1970-01-01 04:00:00,"88a8a0280bfffff",206,599,805
"703",1970-01-01 04:00:00,"88a8a02825fffff",51,150,201
"704",1970-01-01 04:00:00,"88a8a02829fffff",51,150,201
"705",1970-01-01 04:00:00,"88a8a0282dfffff",51,150,201
"706",1970-01-01 04:00:00,"88a8a02853fffff",155,449,604
"707",1970-01-01 04:00:00,"88a8a02857fffff",155,449,604
"708",1970-01-01 04:00:00,"88a8a02919fffff",51,150,201
"709",1970-01-01 04:00:00,"88a8a02957fffff",51,150,201
"710",1970-01-01 04:00:00,"88a8a02a05fffff",60,103,163
"711",1970-01-01 04:00:00,"88a8a02a11fffff",53,149,202
"712",1970-01-01 04:00:00,"88a8a02a19fffff",104,299,403
"713",1970-01-01 04:00:00,"88a8a02a57fffff",104,299,403
"714",1970-01-01 04:00:00,"88a8a02a63fffff",111,253,364
"715",1970-01-01 04:00:00,"88a8a02a69fffff",111,253,364
"716",1970-01-01 04:00:00,"88a8a02a6bfffff",51,150,201
"717",1970-01-01 04:00:00,"88a8a02a89fffff",104,299,403
"718",1970-01-01 04:00:00,"88a8a02a8bfffff",51,150,201
"719",1970-01-01 04:00:00,"88a8a02a9dfffff",206,599,805
"720",1970-01-01 04:00:00,"88a8a02aadfffff",104,299,403
"721",1970-01-01 04:00:00,"88a8a02ac7fffff",104,299,403
"722",1970-01-01 04:00:00,"88a8a02ae3fffff",104,299,403
"723",1970-01-01 04:00:00,"88a8a02ae7fffff",104,299,403
"724",1970-01-01 04:00:00,"88a8a02aebfffff",104,299,403
"725",1970-01-01 04:00:00,"88a8a03987fffff",111,253,364
"726",1970-01-01 04:00:00,"88a8a03995fffff",111,253,364
"727",1970-01-01 04:00:00,"88a8a03997fffff",111,253,364
"728",1970-01-01 04:00:00,"88a8a039a1fffff",171,356,527
"729",1970-01-01 04:00:00,"88a8a039abfffff",240,412,652
"730",1970-01-01 04:00:00,"88a8a039adfffff",351,665,1016
"731",1970-01-01 04:00:00,"88a8a039b9fffff",291,562,853
"732",1970-01-01 04:00:00,"88a8a039bbfffff",342,712,1054
"733",1970-01-01 04:00:00,"88a8a039bdfffff",120,206,326
"734",1970-01-01 04:00:00,"88a8a0608dfffff",120,206,326
"735",1970-01-01 04:00:00,"88a8a060c3fffff",60,103,163
"736",1970-01-01 04:00:00,"88a8a060c7fffff",60,103,163
"737",1970-01-01 04:00:00,"88a8a060cbfffff",60,103,163
"738",1970-01-01 04:00:00,"88a8a061a1fffff",102,300,402
"739",1970-01-01 04:00:00,"88a8a061a3fffff",102,300,402
"740",1970-01-01 04:00:00,"88a8a061a5fffff",150,396,546
"741",1970-01-01 04:00:00,"88a8a061b1fffff",51,150,201
"742",1970-01-01 04:00:00,"88a8a061b3fffff",51,150,201
"743",1970-01-01 04:00:00,"88a8a061b5fffff",102,300,402
"744",1970-01-01 04:00:00,"88a8a061b7fffff",204,600,804
"745",1970-01-01 04:00:00,"88a8a06249fffff",120,206,326
"746",1970-01-01 04:00:00,"88a8a0624bfffff",120,206,326
"747",1970-01-01 04:00:00,"88a8a0624dfffff",120,206,326
"748",1970-01-01 04:00:00,"88a8a06281fffff",60,103,163
"749",1970-01-01 04:00:00,"88a8a06283fffff",60,103,163
"750",1970-01-01 04:00:00,"88a8a06287fffff",60,103,163
"751",1970-01-01 04:00:00,"88a8a06289fffff",60,103,163
"752",1970-01-01 04:00:00,"88a8a06293fffff",0,0,0
"753",1970-01-01 04:00:00,"88a8a062b5fffff",60,103,163
"754",1970-01-01 04:00:00,"88a8a062bdfffff",60,103,163
"755",1970-01-01 04:00:00,"88a8a062c3fffff",60,103,163
"756",1970-01-01 04:00:00,"88a8a062cbfffff",60,103,163
"757",1970-01-01 04:00:00,"88a8a062d1fffff",120,206,326
"758",1970-01-01 04:00:00,"88a8a062d3fffff",120,206,326
"759",1970-01-01 04:00:00,"88a8a062d9fffff",120,206,326
"760",1970-01-01 04:00:00,"88a8a06541fffff",60,103,163
"761",1970-01-01 04:00:00,"88a8a06549fffff",60,103,163
"762",1970-01-01 04:00:00,"88a8a06705fffff",60,103,163
"763",1970-01-01 04:00:00,"88a8a06707fffff",60,103,163
"764",1970-01-01 04:00:00,"88a8a0670dfffff",0,0,0
"765",1970-01-01 04:00:00,"88a8a0672bfffff",0,0,0
"766",1970-01-01 04:00:00,"88a8a06731fffff",120,206,326
"767",1970-01-01 04:00:00,"88a8a06735fffff",120,206,326
"768",1970-01-01 04:00:00,"88a8a06739fffff",120,206,326
"769",1970-01-01 04:00:00,"88a8a0674dfffff",0,0,0
"770",1970-01-01 04:00:00,"88a8a0676bfffff",0,0,0
"771",1970-01-01 04:00:00,"88a8a06a91fffff",48,96,144
"772",1970-01-01 04:00:00,"88a8a06a9bfffff",147,342,489
"773",1970-01-01 04:00:00,"88a8a06f05fffff",48,96,144
"774",1970-01-01 04:00:00,"88a8a06f61fffff",99,246,345
"775",1970-01-01 04:00:00,"88a8a06f63fffff",48,96,144
"776",1970-01-01 04:00:00,"88a8a06f67fffff",96,192,288
"777",1970-01-01 04:00:00,"88a8a06f69fffff",147,342,489
"778",1970-01-01 04:00:00,"88a8a070b3fffff",120,206,326
"779",1970-01-01 04:00:00,"88a8a070b7fffff",120,206,326
"780",1970-01-01 04:00:00,"88a8a0719bfffff",120,206,326
"781",1970-01-01 04:00:00,"88a8a07441fffff",480,824,1304
"782",1970-01-01 04:00:00,"88a8a07443fffff",120,206,326
"783",1970-01-01 04:00:00,"88a8a07445fffff",300,515,815
"784",1970-01-01 04:00:00,"88a8a07447fffff",420,721,1141
"785",1970-01-01 04:00:00,"88a8a0744bfffff",480,824,1304
"786",1970-01-01 04:00:00,"88a8a07461fffff",540,927,1467
"787",1970-01-01 04:00:00,"88a8a07465fffff",300,515,815
"788",1970-01-01 04:00:00,"88a8a07467fffff",180,309,489
"789",1970-01-01 04:00:00,"88a8a0746bfffff",480,824,1304
"790",1970-01-01 04:00:00,"88a8a07503fffff",60,103,163
"791",1970-01-01 04:00:00,"88a8a07507fffff",300,515,815
"792",1970-01-01 04:00:00,"88a8a07515fffff",240,412,652
"793",1970-01-01 04:00:00,"88a8a0751dfffff",60,103,163
"794",1970-01-01 04:00:00,"88a8a07521fffff",60,103,163
"795",1970-01-01 04:00:00,"88a8a07525fffff",60,103,163
"796",1970-01-01 04:00:00,"88a8a0752bfffff",60,103,163
"797",1970-01-01 04:00:00,"88a8a0752dfffff",60,103,163
"798",1970-01-01 04:00:00,"88a8a07531fffff",420,721,1141
"799",1970-01-01 04:00:00,"88a8a07533fffff",60,103,163
"800",1970-01-01 04:00:00,"88a8a07535fffff",120,206,326
"801",1970-01-01 04:00:00,"88a8a07537fffff",60,103,163
"802",1970-01-01 04:00:00,"88a8a07539fffff",660,1133,1793
"803",1970-01-01 04:00:00,"88a8a0753dfffff",120,206,326
"804",1970-01-01 04:00:00,"88a8a07543fffff",300,515,815
"805",1970-01-01 04:00:00,"88a8a07545fffff",180,309,489
"806",1970-01-01 04:00:00,"88a8a07547fffff",420,721,1141
"807",1970-01-01 04:00:00,"88a8a07553fffff",120,206,326
"808",1970-01-01 04:00:00,"88a8a07557fffff",0,0,0
"809",1970-01-01 04:00:00,"88a8a07559fffff",360,618,978
"810",1970-01-01 04:00:00,"88a8a0755bfffff",240,412,652
"811",1970-01-01 04:00:00,"88a8a0755dfffff",360,618,978
"812",1970-01-01 04:00:00,"88a8a07561fffff",60,103,163
"813",1970-01-01 04:00:00,"88a8a07567fffff",60,103,163
"814",1970-01-01 04:00:00,"88a8a07569fffff",480,824,1304
"815",1970-01-01 04:00:00,"88a8a0756bfffff",420,721,1141
"816",1970-01-01 04:00:00,"88a8a0756dfffff",240,412,652
"817",1970-01-01 04:00:00,"88a8a07633fffff",360,618,978
"818",1970-01-01 04:00:00,"88a8a07637fffff",480,824,1304
"819",1970-01-01 04:00:00,"88a8a076c3fffff",60,103,163
"820",1970-01-01 04:00:00,"88a8a076c7fffff",240,412,652
"821",1970-01-01 04:00:00,"88a8a076d1fffff",120,206,326
"822",1970-01-01 04:00:00,"88a8a076d3fffff",231,459,690
"823",1970-01-01 04:00:00,"88a8a076d5fffff",222,506,728
"824",1970-01-01 04:00:00,"88a8a076d7fffff",162,403,565
"825",1970-01-01 04:00:00,"88a8a076e9fffff",240,412,652
"826",1970-01-01 04:00:00,"88a8a076ebfffff",180,309,489
"827",1970-01-01 04:00:00,"88a8a076edfffff",240,412,652
"828",1970-01-01 04:30:00,"88a8a02801fffff",195,532,727
"829",1970-01-01 04:30:00,"88a8a02809fffff",0,0,0
"830",1970-01-01 04:30:00,"88a8a0280bfffff",192,453,645
"831",1970-01-01 04:30:00,"88a8a02853fffff",192,453,645
"832",1970-01-01 04:30:00,"88a8a02857fffff",243,603,846
"833",1970-01-01 04:30:00,"88a8a02a01fffff",60,103,163
"834",1970-01-01 04:30:00,"88a8a02a05fffff",60,103,163
"835",1970-01-01 04:30:00,"88a8a02a0bfffff",51,150,201
"836",1970-01-01 04:30:00,"88a8a02a11fffff",51,150,201
"837",1970-01-01 04:30:00,"88a8a02a13fffff",51,150,201
"838",1970-01-01 04:30:00,"88a8a02a19fffff",159,324,483
"839",1970-01-01 04:30:00,"88a8a02a57fffff",99,221,320
"840",1970-01-01 04:30:00,"88a8a02a61fffff",60,103,163
"841",1970-01-01 04:30:00,"88a8a02a63fffff",60,103,163
"842",1970-01-01 04:30:00,"88a8a02a69fffff",113,252,365
"843",1970-01-01 04:30:00,"88a8a02a89fffff",204,600,804
"844",1970-01-01 04:30:00,"88a8a02a8bfffff",153,450,603
"845",1970-01-01 04:30:00,"88a8a02a9dfffff",153,450,603
"846",1970-01-01 04:30:00,"88a8a02aadfffff",294,753,1047
"847",1970-01-01 04:30:00,"88a8a02ac5fffff",99,221,320
"848",1970-01-01 04:30:00,"88a8a02ac7fffff",345,903,1248
"849",1970-01-01 04:30:00,"88a8a02ae3fffff",294,753,1047
"850",1970-01-01 04:30:00,"88a8a02ae7fffff",192,453,645
"851",1970-01-01 04:30:00,"88a8a02aebfffff",294,753,1047
"852",1970-01-01 04:30:00,"88a8a03987fffff",173,355,528
"853",1970-01-01 04:30:00,"88a8a03995fffff",180,309,489
"854",1970-01-01 04:30:00,"88a8a03997fffff",173,355,528
"855",1970-01-01 04:30:00,"88a8a039a1fffff",713,1282,1995
"856",1970-01-01 04:30:00,"88a8a039abfffff",833,1488,2321
"857",1970-01-01 04:30:00,"88a8a039adfffff",713,1282,1995
"858",1970-01-01 04:30:00,"88a8a039b9fffff",713,1282,1995
"859",1970-01-01 04:30:00,"88a8a039bbfffff",413,767,1180
"860",1970-01-01 04:30:00,"88a8a039bdfffff",480,824,1304
"861",1970-01-01 04:30:00,"88a8a06085fffff",213,553,766
"862",1970-01-01 04:30:00,"88a8a0608dfffff",231,459,690
"863",1970-01-01 04:30:00,"88a8a060a3fffff",153,450,603
"864",1970-01-01 04:30:00,"88a8a060abfffff",51,150,201
"865",1970-01-01 04:30:00,"88a8a060c1fffff",60,103,163
"866",1970-01-01 04:30:00,"88a8a060c3fffff",180,309,489
"867",1970-01-01 04:30:00,"88a8a060c7fffff",180,309,489
"868",1970-01-01 04:30:00,"88a8a060cbfffff",231,459,690
"869",1970-01-01 04:30:00,"88a8a06193fffff",204,600,804
"870",1970-01-01 04:30:00,"88a8a06197fffff",144,382,526
"871",1970-01-01 04:30:00,"88a8a061a1fffff",195,532,727
"872",1970-01-01 04:30:00,"88a8a061a3fffff",144,382,526
"873",1970-01-01 04:30:00,"88a8a061a5fffff",102,300,402
"874",1970-01-01 04:30:00,"88a8a061b1fffff",93,232,325
"875",1970-01-01 04:30:00,"88a8a061b3fffff",144,382,526
"876",1970-01-01 04:30:00,"88a8a061b5fffff",93,232,325
"877",1970-01-01 04:30:00,"88a8a061b7fffff",51,150,201
"878",1970-01-01 04:30:00,"88a8a06249fffff",180,309,489
"879",1970-01-01 04:30:00,"88a8a0624bfffff",180,309,489
"880",1970-01-01 04:30:00,"88a8a0624dfffff",240,412,652
"881",1970-01-01 04:30:00,"88a8a06281fffff",60,103,163
"882",1970-01-01 04:30:00,"88a8a06283fffff",171,356,527
"883",1970-01-01 04:30:00,"88a8a06287fffff",231,459,690
"884",1970-01-01 04:30:00,"88a8a06289fffff",171,356,527
"885",1970-01-01 04:30:00,"88a8a0628bfffff",51,150,201
"886",1970-01-01 04:30:00,"88a8a0629bfffff",0,0,0
"887",1970-01-01 04:30:00,"88a8a062b5fffff",291,562,853
"888",1970-01-01 04:30:00,"88a8a062bdfffff",291,562,853
"889",1970-01-01 04:30:00,"88a8a062c1fffff",60,103,163
"890",1970-01-01 04:30:00,"88a8a062c3fffff",291,562,853
"891",1970-01-01 04:30:00,"88a8a062cbfffff",240,412,652
"892",1970-01-01 04:30:00,"88a8a062d3fffff",0,0,0
"893",1970-01-01 04:30:00,"88a8a06541fffff",60,103,163
"894",1970-01-01 04:30:00,"88a8a06549fffff",120,206,326
"895",1970-01-01 04:30:00,"88a8a06705fffff",60,103,163
"896",1970-01-01 04:30:00,"88a8a06707fffff",60,103,163
"897",1970-01-01 04:30:00,"88a8a0672bfffff",60,103,163
"898",1970-01-01 04:30:00,"88a8a06731fffff",0,0,0
"899",1970-01-01 04:30:00,"88a8a06735fffff",120,206,326
"900",1970-01-01 04:30:00,"88a8a06739fffff",0,0,0
"901",1970-01-01 04:30:00,"88a8a0676bfffff",60,103,163
"902",1970-01-01 04:30:00,"88a8a06e49fffff",153,450,603
"903",1970-01-01 04:30:00,"88a8a06e4dfffff",153,450,603
"904",1970-01-01 04:30:00,"88a8a06e69fffff",51,150,201
"905",1970-01-01 04:30:00,"88a8a06e6dfffff",246,682,928
"906",1970-01-01 04:30:00,"88a8a06f05fffff",51,150,201
"907",1970-01-01 04:30:00,"88a8a06f61fffff",51,150,201
"908",1970-01-01 04:30:00,"88a8a06f63fffff",102,300,402
"909",1970-01-01 04:30:00,"88a8a06f67fffff",51,150,201
"910",1970-01-01 04:30:00,"88a8a06f69fffff",102,300,402
"911",1970-01-01 04:30:00,"88a8a070b3fffff",180,309,489
"912",1970-01-01 04:30:00,"88a8a070b7fffff",180,309,489
"913",1970-01-01 04:30:00,"88a8a0719bfffff",60,103,163
"914",1970-01-01 04:30:00,"88a8a07441fffff",464,917,1381
"915",1970-01-01 04:30:00,"88a8a07445fffff",515,1067,1582
"916",1970-01-01 04:30:00,"88a8a07447fffff",291,562,853
"917",1970-01-01 04:30:00,"88a8a0744bfffff",464,917,1381
"918",1970-01-01 04:30:00,"88a8a07461fffff",702,1330,2032
"919",1970-01-01 04:30:00,"88a8a07465fffff",573,1171,1744
"920",1970-01-01 04:30:00,"88a8a07467fffff",120,206,326
"921",1970-01-01 04:30:00,"88a8a07469fffff",60,103,163
"922",1970-01-01 04:30:00,"88a8a0746bfffff",695,1376,2071
"923",1970-01-01 04:30:00,"88a8a07503fffff",0,0,0
"924",1970-01-01 04:30:00,"88a8a07507fffff",240,412,652
"925",1970-01-01 04:30:00,"88a8a07515fffff",240,412,652
"926",1970-01-01 04:30:00,"88a8a0751dfffff",120,206,326
"927",1970-01-01 04:30:00,"88a8a07521fffff",180,309,489
"928",1970-01-01 04:30:00,"88a8a07525fffff",180,309,489
"929",1970-01-01 04:30:00,"88a8a0752bfffff",180,309,489
"930",1970-01-01 04:30:00,"88a8a0752dfffff",180,309,489
"931",1970-01-01 04:30:00,"88a8a07531fffff",300,515,815
"932",1970-01-01 04:30:00,"88a8a07533fffff",0,0,0
"933",1970-01-01 04:30:00,"88a8a07535fffff",180,309,489
"934",1970-01-01 04:30:00,"88a8a07537fffff",60,103,163
"935",1970-01-01 04:30:00,"88a8a07539fffff",600,1030,1630
"936",1970-01-01 04:30:00,"88a8a0753bfffff",60,103,163
"937",1970-01-01 04:30:00,"88a8a0753dfffff",360,618,978
"938",1970-01-01 04:30:00,"88a8a07543fffff",393,862,1255
"939",1970-01-01 04:30:00,"88a8a07545fffff",222,506,728
"940",1970-01-01 04:30:00,"88a8a07547fffff",393,862,1255
"941",1970-01-01 04:30:00,"88a8a07553fffff",120,206,326
"942",1970-01-01 04:30:00,"88a8a07557fffff",120,206,326
"943",1970-01-01 04:30:00,"88a8a07559fffff",453,965,1418
"944",1970-01-01 04:30:00,"88a8a0755bfffff",120,206,326
"945",1970-01-01 04:30:00,"88a8a0755dfffff",453,965,1418
"946",1970-01-01 04:30:00,"88a8a07561fffff",120,206,326
"947",1970-01-01 04:30:00,"88a8a07565fffff",60,103,163
"948",1970-01-01 04:30:00,"88a8a07567fffff",180,309,489
"949",1970-01-01 04:30:00,"88a8a07569fffff",342,712,1054
"950",1970-01-01 04:30:00,"88a8a0756bfffff",282,609,891
"951",1970-01-01 04:30:00,"88a8a0756dfffff",333,759,1092
"952",1970-01-01 04:30:00,"88a8a07633fffff",473,870,1343
"953",1970-01-01 04:30:00,"88a8a07637fffff",473,870,1343
"954",1970-01-01 04:30:00,"88a8a076c7fffff",300,515,815
"955",1970-01-01 04:30:00,"88a8a076d1fffff",360,618,978
"956",1970-01-01 04:30:00,"88a8a076d3fffff",713,1282,1995
"957",1970-01-01 04:30:00,"88a8a076d5fffff",413,767,1180
"958",1970-01-01 04:30:00,"88a8a076d7fffff",180,309,489
"959",1970-01-01 04:30:00,"88a8a076e9fffff",593,1076,1669
"960",1970-01-01 04:30:00,"88a8a076ebfffff",420,721,1141
"961",1970-01-01 04:30:00,"88a8a076edfffff",593,1076,1669
"962",1970-01-01 05:00:00,"88a8a02801fffff",192,453,645
"963",1970-01-01 05:00:00,"88a8a02809fffff",51,150,201
"964",1970-01-01 05:00:00,"88a8a0280bfffff",150,371,521
"965",1970-01-01 05:00:00,"88a8a02853fffff",102,300,402
"966",1970-01-01 05:00:00,"88a8a02857fffff",102,300,402
"967",1970-01-01 05:00:00,"88a8a02a01fffff",108,174,282
"968",1970-01-01 05:00:00,"88a8a02a05fffff",210,474,684
"969",1970-01-01 05:00:00,"88a8a02a0bfffff",96,142,238
"970",1970-01-01 05:00:00,"88a8a02a0dfffff",51,150,201
"971",1970-01-01 05:00:00,"88a8a02a11fffff",51,150,201
"972",1970-01-01 05:00:00,"88a8a02a19fffff",201,406,607
"973",1970-01-01 05:00:00,"88a8a02a57fffff",207,395,602
"974",1970-01-01 05:00:00,"88a8a02a61fffff",171,356,527
"975",1970-01-01 05:00:00,"88a8a02a63fffff",330,680,1010
"976",1970-01-01 05:00:00,"88a8a02a69fffff",381,830,1211
"977",1970-01-01 05:00:00,"88a8a02a6bfffff",60,103,163
"978",1970-01-01 05:00:00,"88a8a02a6dfffff",51,150,201
"979",1970-01-01 05:00:00,"88a8a02a89fffff",257,749,1006
"980",1970-01-01 05:00:00,"88a8a02a8bfffff",155,449,604
"981",1970-01-01 05:00:00,"88a8a02aadfffff",102,300,402
"982",1970-01-01 05:00:00,"88a8a02ac5fffff",144,382,526
"983",1970-01-01 05:00:00,"88a8a02ac7fffff",257,749,1006
"984",1970-01-01 05:00:00,"88a8a02ae3fffff",102,300,402
"985",1970-01-01 05:00:00,"88a8a02ae7fffff",51,150,201
"986",1970-01-01 05:00:00,"88a8a02aebfffff",102,300,402
"987",1970-01-01 05:00:00,"88a8a03987fffff",111,253,364
"988",1970-01-01 05:00:00,"88a8a03995fffff",288,483,771
"989",1970-01-01 05:00:00,"88a8a03997fffff",330,680,1010
"990",1970-01-01 05:00:00,"88a8a039a1fffff",612,1289,1901
"991",1970-01-01 05:00:00,"88a8a039abfffff",681,1345,2026
"992",1970-01-01 05:00:00,"88a8a039adfffff",732,1495,2227
"993",1970-01-01 05:00:00,"88a8a039b9fffff",741,1448,2189
"994",1970-01-01 05:00:00,"88a8a039bbfffff",792,1598,2390
"995",1970-01-01 05:00:00,"88a8a039bdfffff",342,712,1054
"996",1970-01-01 05:00:00,"88a8a06085fffff",672,1558,2230
"997",1970-01-01 05:00:00,"88a8a0608dfffff",519,1223,1742
"998",1970-01-01 05:00:00,"88a8a060a3fffff",357,935,1292
"999",1970-01-01 05:00:00,"88a8a060abfffff",255,635,890
"1000",1970-01-01 05:00:00,"88a8a060c3fffff",162,403,565
"1001",1970-01-01 05:00:00,"88a8a060c7fffff",222,506,728
"1002",1970-01-01 05:00:00,"88a8a060cbfffff",222,506,728
"1003",1970-01-01 05:00:00,"88a8a06193fffff",357,935,1292
"1004",1970-01-01 05:00:00,"88a8a06197fffff",204,600,804
"1005",1970-01-01 05:00:00,"88a8a0619bfffff",111,253,364
"1006",1970-01-01 05:00:00,"88a8a061a1fffff",345,928,1273
"1007",1970-01-01 05:00:00,"88a8a061a3fffff",297,832,1129
"1008",1970-01-01 05:00:00,"88a8a061a5fffff",201,546,747
"1009",1970-01-01 05:00:00,"88a8a061b1fffff",222,506,728
"1010",1970-01-01 05:00:00,"88a8a061b3fffff",366,1003,1369
"1011",1970-01-01 05:00:00,"88a8a061b5fffff",297,832,1129
"1012",1970-01-01 05:00:00,"88a8a061b7fffff",408,1085,1493
"1013",1970-01-01 05:00:00,"88a8a06249fffff",60,103,163
"1014",1970-01-01 05:00:00,"88a8a0624bfffff",60,103,163
"1015",1970-01-01 05:00:00,"88a8a0624dfffff",0,0,0
"1016",1970-01-01 05:00:00,"88a8a06281fffff",111,253,364
"1017",1970-01-01 05:00:00,"88a8a06283fffff",231,459,690
"1018",1970-01-01 05:00:00,"88a8a06287fffff",171,356,527
"1019",1970-01-01 05:00:00,"88a8a06289fffff",291,562,853
"1020",1970-01-01 05:00:00,"88a8a0628bfffff",60,103,163
"1021",1970-01-01 05:00:00,"88a8a06293fffff",0,0,0
"1022",1970-01-01 05:00:00,"88a8a06299fffff",0,0,0
"1023",1970-01-01 05:00:00,"88a8a0629bfffff",0,0,0
"1024",1970-01-01 05:00:00,"88a8a062b5fffff",222,506,728
"1025",1970-01-01 05:00:00,"88a8a062bdfffff",171,356,527
"1026",1970-01-01 05:00:00,"88a8a062c3fffff",171,356,527
"1027",1970-01-01 05:00:00,"88a8a062cbfffff",222,506,728
"1028",1970-01-01 05:00:00,"88a8a062d1fffff",0,0,0
"1029",1970-01-01 05:00:00,"88a8a062d3fffff",0,0,0
"1030",1970-01-01 05:00:00,"88a8a062d9fffff",120,206,326
"1031",1970-01-01 05:00:00,"88a8a06705fffff",0,0,0
"1032",1970-01-01 05:00:00,"88a8a0670dfffff",0,0,0
"1033",1970-01-01 05:00:00,"88a8a06731fffff",60,103,163
"1034",1970-01-01 05:00:00,"88a8a0676bfffff",0,0,0
"1035",1970-01-01 05:00:00,"88a8a06a91fffff",99,246,345
"1036",1970-01-01 05:00:00,"88a8a06a9bfffff",150,396,546
"1037",1970-01-01 05:00:00,"88a8a06e49fffff",255,635,890
"1038",1970-01-01 05:00:00,"88a8a06e4dfffff",306,785,1091
"1039",1970-01-01 05:00:00,"88a8a06e69fffff",111,253,364
"1040",1970-01-01 05:00:00,"88a8a06e6dfffff",366,1003,1369
"1041",1970-01-01 05:00:00,"88a8a06f05fffff",51,150,201
"1042",1970-01-01 05:00:00,"88a8a06f61fffff",51,150,201
"1043",1970-01-01 05:00:00,"88a8a06f63fffff",102,300,402
"1044",1970-01-01 05:00:00,"88a8a070b3fffff",60,103,163
"1045",1970-01-01 05:00:00,"88a8a070b7fffff",60,103,163
"1046",1970-01-01 05:00:00,"88a8a0719bfffff",0,0,0
"1047",1970-01-01 05:00:00,"88a8a07441fffff",693,1377,2070
"1048",1970-01-01 05:00:00,"88a8a07445fffff",453,965,1418
"1049",1970-01-01 05:00:00,"88a8a07447fffff",462,918,1380
"1050",1970-01-01 05:00:00,"88a8a0744bfffff",633,1274,1907
"1051",1970-01-01 05:00:00,"88a8a07461fffff",628,1319,1947
"1052",1970-01-01 05:00:00,"88a8a07465fffff",517,1066,1583
"1053",1970-01-01 05:00:00,"88a8a07467fffff",120,206,326
"1054",1970-01-01 05:00:00,"88a8a07469fffff",0,0,0
"1055",1970-01-01 05:00:00,"88a8a0746bfffff",746,1526,2272
"1056",1970-01-01 05:00:00,"88a8a07503fffff",0,0,0
"1057",1970-01-01 05:00:00,"88a8a07507fffff",231,459,690
"1058",1970-01-01 05:00:00,"88a8a07515fffff",360,618,978
"1059",1970-01-01 05:00:00,"88a8a0751dfffff",240,412,652
"1060",1970-01-01 05:00:00,"88a8a07521fffff",282,609,891
"1061",1970-01-01 05:00:00,"88a8a07525fffff",222,506,728
"1062",1970-01-01 05:00:00,"88a8a0752bfffff",342,712,1054
"1063",1970-01-01 05:00:00,"88a8a0752dfffff",282,609,891
"1064",1970-01-01 05:00:00,"88a8a07531fffff",342,712,1054
"1065",1970-01-01 05:00:00,"88a8a07535fffff",282,609,891
"1066",1970-01-01 05:00:00,"88a8a07537fffff",120,206,326
"1067",1970-01-01 05:00:00,"88a8a07539fffff",642,1227,1869
"1068",1970-01-01 05:00:00,"88a8a0753bfffff",60,103,163
"1069",1970-01-01 05:00:00,"88a8a0753dfffff",120,206,326
"1070",1970-01-01 05:00:00,"88a8a07543fffff",577,1169,1746
"1071",1970-01-01 05:00:00,"88a8a07545fffff",457,963,1420
"1072",1970-01-01 05:00:00,"88a8a07547fffff",466,916,1382
"1073",1970-01-01 05:00:00,"88a8a07553fffff",240,412,652
"1074",1970-01-01 05:00:00,"88a8a07557fffff",240,412,652
"1075",1970-01-01 05:00:00,"88a8a07559fffff",517,1066,1583
"1076",1970-01-01 05:00:00,"88a8a0755bfffff",180,309,489
"1077",1970-01-01 05:00:00,"88a8a0755dfffff",517,1066,1583
"1078",1970-01-01 05:00:00,"88a8a07561fffff",291,562,853
"1079",1970-01-01 05:00:00,"88a8a07565fffff",0,0,0
"1080",1970-01-01 05:00:00,"88a8a07567fffff",231,459,690
"1081",1970-01-01 05:00:00,"88a8a07569fffff",457,963,1420
"1082",1970-01-01 05:00:00,"88a8a0756bfffff",517,1066,1583
"1083",1970-01-01 05:00:00,"88a8a0756dfffff",464,917,1381
"1084",1970-01-01 05:00:00,"88a8a07633fffff",573,1171,1744
"1085",1970-01-01 05:00:00,"88a8a07637fffff",522,1021,1543
"1086",1970-01-01 05:00:00,"88a8a076c7fffff",402,815,1217
"1087",1970-01-01 05:00:00,"88a8a076d1fffff",342,712,1054
"1088",1970-01-01 05:00:00,"88a8a076d3fffff",630,1195,1825
"1089",1970-01-01 05:00:00,"88a8a076d5fffff",390,783,1173
"1090",1970-01-01 05:00:00,"88a8a076d7fffff",171,356,527
"1091",1970-01-01 05:00:00,"88a8a076e9fffff",573,1171,1744
"1092",1970-01-01 05:00:00,"88a8a076ebfffff",291,562,853
"1093",1970-01-01 05:00:00,"88a8a076edfffff",411,768,1179
"1094",1970-01-01 05:30:00,"88a8a02801fffff",48,71,119
"1095",1970-01-01 05:30:00,"88a8a02805fffff",42,82,124
"1096",1970-01-01 05:30:00,"88a8a02809fffff",102,300,402
"1097",1970-01-01 05:30:00,"88a8a0280bfffff",33,60,93
"1098",1970-01-01 05:30:00,"88a8a02829fffff",42,82,124
"1099",1970-01-01 05:30:00,"88a8a0282dfffff",42,82,124
"1100",1970-01-01 05:30:00,"88a8a02853fffff",81,131,212
"1101",1970-01-01 05:30:00,"88a8a02857fffff",81,131,212
"1102",1970-01-01 05:30:00,"88a8a0291dfffff",42,82,124
"1103",1970-01-01 05:30:00,"88a8a02953fffff",42,82,124
"1104",1970-01-01 05:30:00,"88a8a02957fffff",84,164,248
"1105",1970-01-01 05:30:00,"88a8a02a01fffff",213,553,766
"1106",1970-01-01 05:30:00,"88a8a02a05fffff",374,876,1250
"1107",1970-01-01 05:30:00,"88a8a02a09fffff",51,150,201
"1108",1970-01-01 05:30:00,"88a8a02a0bfffff",102,300,402
"1109",1970-01-01 05:30:00,"88a8a02a0dfffff",99,221,320
"1110",1970-01-01 05:30:00,"88a8a02a11fffff",254,670,924
"1111",1970-01-01 05:30:00,"88a8a02a13fffff",254,670,924
"1112",1970-01-01 05:30:00,"88a8a02a19fffff",254,670,924
"1113",1970-01-01 05:30:00,"88a8a02a57fffff",215,552,767
"1114",1970-01-01 05:30:00,"88a8a02a61fffff",215,552,767
"1115",1970-01-01 05:30:00,"88a8a02a63fffff",314,773,1087
"1116",1970-01-01 05:30:00,"88a8a02a69fffff",319,851,1170
"1117",1970-01-01 05:30:00,"88a8a02a6bfffff",51,150,201
"1118",1970-01-01 05:30:00,"88a8a02a89fffff",255,750,1005
"1119",1970-01-01 05:30:00,"88a8a02a8bfffff",357,1050,1407
"1120",1970-01-01 05:30:00,"88a8a02a9dfffff",255,750,1005
"1121",1970-01-01 05:30:00,"88a8a02aa9fffff",0,0,0
"1122",1970-01-01 05:30:00,"88a8a02aadfffff",48,71,119
"1123",1970-01-01 05:30:00,"88a8a02ac5fffff",254,670,924
"1124",1970-01-01 05:30:00,"88a8a02ac7fffff",303,821,1124
"1125",1970-01-01 05:30:00,"88a8a02ae3fffff",48,71,119
"1126",1970-01-01 05:30:00,"88a8a02aebfffff",0,0,0
"1127",1970-01-01 05:30:00,"88a8a03987fffff",384,794,1178
"1128",1970-01-01 05:30:00,"88a8a03995fffff",388,907,1295
"1129",1970-01-01 05:30:00,"88a8a03997fffff",367,922,1289
"1130",1970-01-01 05:30:00,"88a8a039a1fffff",832,1804,2636
"1131",1970-01-01 05:30:00,"88a8a039abfffff",883,1954,2837
"1132",1970-01-01 05:30:00,"88a8a039adfffff",781,1654,2435
"1133",1970-01-01 05:30:00,"88a8a039b9fffff",892,1907,2799
"1134",1970-01-01 05:30:00,"88a8a039bbfffff",550,1195,1745
"1135",1970-01-01 05:30:00,"88a8a039bdfffff",326,805,1131
"1136",1970-01-01 05:30:00,"88a8a06081fffff",51,150,201
"1137",1970-01-01 05:30:00,"88a8a06085fffff",684,1586,2270
"1138",1970-01-01 05:30:00,"88a8a0608dfffff",900,1963,2863
"1139",1970-01-01 05:30:00,"88a8a060a3fffff",462,1080,1542
"1140",1970-01-01 05:30:00,"88a8a060a7fffff",48,96,144
"1141",1970-01-01 05:30:00,"88a8a060abfffff",414,984,1398
"1142",1970-01-01 05:30:00,"88a8a060c1fffff",111,253,364
"1143",1970-01-01 05:30:00,"88a8a060c3fffff",657,1335,1992
"1144",1970-01-01 05:30:00,"88a8a060c7fffff",657,1335,1992
"1145",1970-01-01 05:30:00,"88a8a060cbfffff",708,1485,2193
"1146",1970-01-01 05:30:00,"88a8a06193fffff",501,1223,1724
"1147",1970-01-01 05:30:00,"88a8a06197fffff",138,274,412
"1148",1970-01-01 05:30:00,"88a8a0619bfffff",60,103,163
"1149",1970-01-01 05:30:00,"88a8a061a1fffff",384,956,1340
"1150",1970-01-01 05:30:00,"88a8a061a3fffff",390,970,1360
"1151",1970-01-01 05:30:00,"88a8a061a5fffff",51,150,201
"1152",1970-01-01 05:30:00,"88a8a061b1fffff",150,396,546
"1153",1970-01-01 05:30:00,"88a8a061b3fffff",450,1073,1523
"1154",1970-01-01 05:30:00,"88a8a061b5fffff",390,970,1360
"1155",1970-01-01 05:30:00,"88a8a061b7fffff",306,691,997
"1156",1970-01-01 05:30:00,"88a8a06249fffff",240,412,652
"1157",1970-01-01 05:30:00,"88a8a0624bfffff",240,412,652
"1158",1970-01-01 05:30:00,"88a8a0624dfffff",240,412,652
"1159",1970-01-01 05:30:00,"88a8a06281fffff",342,712,1054
"1160",1970-01-01 05:30:00,"88a8a06283fffff",717,1553,2270
"1161",1970-01-01 05:30:00,"88a8a06287fffff",564,1103,1667
"1162",1970-01-01 05:30:00,"88a8a06289fffff",606,1300,1906
"1163",1970-01-01 05:30:00,"88a8a0628bfffff",231,459,690
"1164",1970-01-01 05:30:00,"88a8a06293fffff",240,412,652
"1165",1970-01-01 05:30:00,"88a8a0629bfffff",60,103,163
"1166",1970-01-01 05:30:00,"88a8a062b5fffff",606,1300,1906
"1167",1970-01-01 05:30:00,"88a8a062bdfffff",666,1403,2069
"1168",1970-01-01 05:30:00,"88a8a062c1fffff",51,150,201
"1169",1970-01-01 05:30:00,"88a8a062c3fffff",435,944,1379
"1170",1970-01-01 05:30:00,"88a8a062cbfffff",606,1300,1906
"1171",1970-01-01 05:30:00,"88a8a062d1fffff",420,721,1141
"1172",1970-01-01 05:30:00,"88a8a062d3fffff",480,824,1304
"1173",1970-01-01 05:30:00,"88a8a062d9fffff",360,618,978
"1174",1970-01-01 05:30:00,"88a8a06541fffff",180,309,489
"1175",1970-01-01 05:30:00,"88a8a06549fffff",300,515,815
"1176",1970-01-01 05:30:00,"88a8a06705fffff",120,206,326
"1177",1970-01-01 05:30:00,"88a8a06707fffff",60,103,163
"1178",1970-01-01 05:30:00,"88a8a0670dfffff",60,103,163
"1179",1970-01-01 05:30:00,"88a8a0672bfffff",60,103,163
"1180",1970-01-01 05:30:00,"88a8a06735fffff",360,618,978
"1181",1970-01-01 05:30:00,"88a8a06739fffff",120,206,326
"1182",1970-01-01 05:30:00,"88a8a0673dfffff",0,0,0
"1183",1970-01-01 05:30:00,"88a8a0674dfffff",120,206,326
"1184",1970-01-01 05:30:00,"88a8a0676bfffff",120,206,326
"1185",1970-01-01 05:30:00,"88a8a06a91fffff",102,300,402
"1186",1970-01-01 05:30:00,"88a8a06a9bfffff",51,150,201
"1187",1970-01-01 05:30:00,"88a8a06e49fffff",417,944,1361
"1188",1970-01-01 05:30:00,"88a8a06e4dfffff",459,1026,1485
"1189",1970-01-01 05:30:00,"88a8a06e69fffff",99,246,345
"1190",1970-01-01 05:30:00,"88a8a06e6dfffff",450,1073,1523
"1191",1970-01-01 05:30:00,"88a8a06f05fffff",51,150,201
"1192",1970-01-01 05:30:00,"88a8a06f61fffff",102,300,402
"1193",1970-01-01 05:30:00,"88a8a06f63fffff",51,150,201
"1194",1970-01-01 05:30:00,"88a8a06f67fffff",51,150,201
"1195",1970-01-01 05:30:00,"88a8a06f69fffff",102,300,402
"1196",1970-01-01 05:30:00,"88a8a070b3fffff",240,412,652
"1197",1970-01-01 05:30:00,"88a8a070b7fffff",240,412,652
"1198",1970-01-01 05:30:00,"88a8a0719bfffff",60,103,163
"1199",1970-01-01 05:30:00,"88a8a07441fffff",623,1241,1864
"1200",1970-01-01 05:30:00,"88a8a07445fffff",224,505,729
"1201",1970-01-01 05:30:00,"88a8a07447fffff",413,767,1180
"1202",1970-01-01 05:30:00,"88a8a0744bfffff",623,1241,1864
"1203",1970-01-01 05:30:00,"88a8a07461fffff",681,1345,2026
"1204",1970-01-01 05:30:00,"88a8a07465fffff",519,942,1461
"1205",1970-01-01 05:30:00,"88a8a07467fffff",60,103,163
"1206",1970-01-01 05:30:00,"88a8a07469fffff",102,300,402
"1207",1970-01-01 05:30:00,"88a8a0746bfffff",690,1298,1988
"1208",1970-01-01 05:30:00,"88a8a07503fffff",60,103,163
"1209",1970-01-01 05:30:00,"88a8a07507fffff",864,1618,2482
"1210",1970-01-01 05:30:00,"88a8a07515fffff",531,974,1505
"1211",1970-01-01 05:30:00,"88a8a0751dfffff",111,253,364
"1212",1970-01-01 05:30:00,"88a8a07521fffff",315,738,1053
"1213",1970-01-01 05:30:00,"88a8a07525fffff",273,656,929
"1214",1970-01-01 05:30:00,"88a8a0752bfffff",375,841,1216
"1215",1970-01-01 05:30:00,"88a8a0752dfffff",315,738,1053
"1216",1970-01-01 05:30:00,"88a8a07531fffff",1086,2124,3210
"1217",1970-01-01 05:30:00,"88a8a07533fffff",180,309,489
"1218",1970-01-01 05:30:00,"88a8a07535fffff",546,1197,1743
"1219",1970-01-01 05:30:00,"88a8a07537fffff",240,412,652
"1220",1970-01-01 05:30:00,"88a8a07539fffff",1293,2407,3700
"1221",1970-01-01 05:30:00,"88a8a0753bfffff",111,253,364
"1222",1970-01-01 05:30:00,"88a8a0753dfffff",333,644,977
"1223",1970-01-01 05:30:00,"88a8a07543fffff",471,871,1342
"1224",1970-01-01 05:30:00,"88a8a07545fffff",228,380,608
"1225",1970-01-01 05:30:00,"88a8a07547fffff",468,792,1260
"1226",1970-01-01 05:30:00,"88a8a07553fffff",111,253,364
"1227",1970-01-01 05:30:00,"88a8a07557fffff",51,150,201
"1228",1970-01-01 05:30:00,"88a8a07559fffff",519,942,1461
"1229",1970-01-01 05:30:00,"88a8a0755bfffff",111,253,364
"1230",1970-01-01 05:30:00,"88a8a0755dfffff",519,942,1461
"1231",1970-01-01 05:30:00,"88a8a07561fffff",171,356,527
"1232",1970-01-01 05:30:00,"88a8a07565fffff",51,150,201
"1233",1970-01-01 05:30:00,"88a8a07567fffff",255,635,890
"1234",1970-01-01 05:30:00,"88a8a07569fffff",348,586,934
"1235",1970-01-01 05:30:00,"88a8a0756bfffff",360,618,978
"1236",1970-01-01 05:30:00,"88a8a0756dfffff",432,865,1297
"1237",1970-01-01 05:30:00,"88a8a07633fffff",863,1653,2516
"1238",1970-01-01 05:30:00,"88a8a07637fffff",743,1447,2190
"1239",1970-01-01 05:30:00,"88a8a076c7fffff",326,690,1016
"1240",1970-01-01 05:30:00,"88a8a076d1fffff",386,793,1179
"1241",1970-01-01 05:30:00,"88a8a076d3fffff",661,1448,2109
"1242",1970-01-01 05:30:00,"88a8a076d5fffff",437,943,1380
"1243",1970-01-01 05:30:00,"88a8a076d7fffff",53,149,202
"1244",1970-01-01 05:30:00,"88a8a076e9fffff",464,917,1381
"1245",1970-01-01 05:30:00,"88a8a076ebfffff",284,608,892
"1246",1970-01-01 05:30:00,"88a8a076edfffff",515,1067,1582
"1247",1970-01-01 06:00:00,"88a8a02801fffff",143,302,445
"1248",1970-01-01 06:00:00,"88a8a02805fffff",95,231,326
"1249",1970-01-01 06:00:00,"88a8a02809fffff",0,0,0
"1250",1970-01-01 06:00:00,"88a8a0280bfffff",90,153,243
"1251",1970-01-01 06:00:00,"88a8a02825fffff",42,82,124
"1252",1970-01-01 06:00:00,"88a8a02829fffff",95,231,326
"1253",1970-01-01 06:00:00,"88a8a0282dfffff",95,231,326
"1254",1970-01-01 06:00:00,"88a8a02853fffff",138,224,362
"1255",1970-01-01 06:00:00,"88a8a02857fffff",90,153,243
"1256",1970-01-01 06:00:00,"88a8a02919fffff",95,231,326
"1257",1970-01-01 06:00:00,"88a8a0291dfffff",53,149,202
"1258",1970-01-01 06:00:00,"88a8a02953fffff",95,231,326
"1259",1970-01-01 06:00:00,"88a8a02957fffff",53,149,202
"1260",1970-01-01 06:00:00,"88a8a02a01fffff",296,752,1048
"1261",1970-01-01 06:00:00,"88a8a02a05fffff",396,1053,1449
"1262",1970-01-01 06:00:00,"88a8a02a0bfffff",99,221,320
"1263",1970-01-01 06:00:00,"88a8a02a0dfffff",150,371,521
"1264",1970-01-01 06:00:00,"88a8a02a11fffff",51,150,201
"1265",1970-01-01 06:00:00,"88a8a02a13fffff",102,300,402
"1266",1970-01-01 06:00:00,"88a8a02a19fffff",264,703,967
"1267",1970-01-01 06:00:00,"88a8a02a57fffff",150,371,521
"1268",1970-01-01 06:00:00,"88a8a02a61fffff",195,532,727
"1269",1970-01-01 06:00:00,"88a8a02a63fffff",398,1052,1450
"1270",1970-01-01 06:00:00,"88a8a02a69fffff",465,1109,1574
"1271",1970-01-01 06:00:00,"88a8a02a89fffff",84,210,294
"1272",1970-01-01 06:00:00,"88a8a02a8bfffff",51,150,201
"1273",1970-01-01 06:00:00,"88a8a02a9dfffff",33,60,93
"1274",1970-01-01 06:00:00,"88a8a02aa9fffff",48,71,119
"1275",1970-01-01 06:00:00,"88a8a02aadfffff",171,284,455
"1276",1970-01-01 06:00:00,"88a8a02ac5fffff",102,300,402
"1277",1970-01-01 06:00:00,"88a8a02ac7fffff",180,352,532
"1278",1970-01-01 06:00:00,"88a8a02ae3fffff",129,202,331
"1279",1970-01-01 06:00:00,"88a8a02ae7fffff",123,213,336
"1280",1970-01-01 06:00:00,"88a8a02aebfffff",129,202,331
"1281",1970-01-01 06:00:00,"88a8a03987fffff",423,912,1335
"1282",1970-01-01 06:00:00,"88a8a03995fffff",339,633,972
"1283",1970-01-01 06:00:00,"88a8a03997fffff",525,1212,1737
"1284",1970-01-01 06:00:00,"88a8a039a1fffff",720,1348,2068
"1285",1970-01-01 06:00:00,"88a8a039abfffff",771,1498,2269
"1286",1970-01-01 06:00:00,"88a8a039adfffff",771,1498,2269
"1287",1970-01-01 06:00:00,"88a8a039b9fffff",834,1680,2514
"1288",1970-01-01 06:00:00,"88a8a039bbfffff",825,1727,2552
"1289",1970-01-01 06:00:00,"88a8a039bdfffff",171,356,527
"1290",1970-01-01 06:00:00,"88a8a06081fffff",0,0,0
"1291",1970-01-01 06:00:00,"88a8a06085fffff",654,1443,2097
"1292",1970-01-01 06:00:00,"88a8a0608dfffff",879,1909,2788
"1293",1970-01-01 06:00:00,"88a8a060a3fffff",345,813,1158
"1294",1970-01-01 06:00:00,"88a8a060a7fffff",42,82,124
"1295",1970-01-01 06:00:00,"88a8a060abfffff",303,731,1034
"1296",1970-01-01 06:00:00,"88a8a060c3fffff",435,850,1285
"1297",1970-01-01 06:00:00,"88a8a060c7fffff",549,1157,1706
"1298",1970-01-01 06:00:00,"88a8a060cbfffff",429,951,1380
"1299",1970-01-01 06:00:00,"88a8a06193fffff",450,1052,1502
"1300",1970-01-01 06:00:00,"88a8a06197fffff",543,1284,1827
"1301",1970-01-01 06:00:00,"88a8a061a1fffff",471,1174,1645
"1302",1970-01-01 06:00:00,"88a8a061a3fffff",381,996,1377
"1303",1970-01-01 06:00:00,"88a8a061a5fffff",192,478,670
"1304",1970-01-01 06:00:00,"88a8a061b1fffff",390,949,1339
"1305",1970-01-01 06:00:00,"88a8a061b3fffff",552,1352,1904
"1306",1970-01-01 06:00:00,"88a8a061b5fffff",390,1064,1454
"1307",1970-01-01 06:00:00,"88a8a061b7fffff",687,1781,2468
"1308",1970-01-01 06:00:00,"88a8a06249fffff",240,412,652
"1309",1970-01-01 06:00:00,"88a8a0624bfffff",300,515,815
"1310",1970-01-01 06:00:00,"88a8a0624dfffff",360,618,978
"1311",1970-01-01 06:00:00,"88a8a06281fffff",282,609,891
"1312",1970-01-01 06:00:00,"88a8a06283fffff",642,1389,2031
"1313",1970-01-01 06:00:00,"88a8a06287fffff",582,1286,1868
"1314",1970-01-01 06:00:00,"88a8a06289fffff",798,1778,2576
"1315",1970-01-01 06:00:00,"88a8a0628bfffff",453,1012,1465
"1316",1970-01-01 06:00:00,"88a8a06293fffff",60,103,163
"1317",1970-01-01 06:00:00,"88a8a06299fffff",60,103,163
"1318",1970-01-01 06:00:00,"88a8a0629bfffff",120,206,326
"1319",1970-01-01 06:00:00,"88a8a062b5fffff",471,1033,1504
"1320",1970-01-01 06:00:00,"88a8a062bdfffff",582,1286,1868
"1321",1970-01-01 06:00:00,"88a8a062c1fffff",270,602,872
"1322",1970-01-01 06:00:00,"88a8a062c3fffff",699,1532,2231
"1323",1970-01-01 06:00:00,"88a8a062cbfffff",645,1328,1973
"1324",1970-01-01 06:00:00,"88a8a062d1fffff",300,515,815
"1325",1970-01-01 06:00:00,"88a8a062d3fffff",120,206,326
"1326",1970-01-01 06:00:00,"88a8a062d9fffff",180,309,489
"1327",1970-01-01 06:00:00,"88a8a06541fffff",60,103,163
"1328",1970-01-01 06:00:00,"88a8a06549fffff",60,103,163
"1329",1970-01-01 06:00:00,"88a8a06705fffff",360,618,978
"1330",1970-01-01 06:00:00,"88a8a06707fffff",180,309,489
"1331",1970-01-01 06:00:00,"88a8a0670dfffff",180,309,489
"1332",1970-01-01 06:00:00,"88a8a0672bfffff",60,103,163
"1333",1970-01-01 06:00:00,"88a8a06731fffff",120,206,326
"1334",1970-01-01 06:00:00,"88a8a06735fffff",60,103,163
"1335",1970-01-01 06:00:00,"88a8a06739fffff",180,309,489
"1336",1970-01-01 06:00:00,"88a8a0673dfffff",60,103,163
"1337",1970-01-01 06:00:00,"88a8a0674dfffff",120,206,326
"1338",1970-01-01 06:00:00,"88a8a0676bfffff",300,515,815
"1339",1970-01-01 06:00:00,"88a8a06a91fffff",243,628,871
"1340",1970-01-01 06:00:00,"88a8a06a9bfffff",249,642,891
"1341",1970-01-01 06:00:00,"88a8a06e49fffff",306,785,1091
"1342",1970-01-01 06:00:00,"88a8a06e4dfffff",441,1099,1540
"1343",1970-01-01 06:00:00,"88a8a06e6dfffff",459,1120,1579
"1344",1970-01-01 06:00:00,"88a8a06f05fffff",51,150,201
"1345",1970-01-01 06:00:00,"88a8a06f61fffff",51,150,201
"1346",1970-01-01 06:00:00,"88a8a06f63fffff",102,300,402
"1347",1970-01-01 06:00:00,"88a8a06f67fffff",51,150,201
"1348",1970-01-01 06:00:00,"88a8a06f69fffff",102,300,402
"1349",1970-01-01 06:00:00,"88a8a070b3fffff",360,618,978
"1350",1970-01-01 06:00:00,"88a8a070b7fffff",360,618,978
"1351",1970-01-01 06:00:00,"88a8a0719bfffff",300,515,815
"1352",1970-01-01 06:00:00,"88a8a07441fffff",854,1700,2554
"1353",1970-01-01 06:00:00,"88a8a07443fffff",108,174,282
"1354",1970-01-01 06:00:00,"88a8a07445fffff",565,1137,1702
"1355",1970-01-01 06:00:00,"88a8a07447fffff",512,988,1500
"1356",1970-01-01 06:00:00,"88a8a0744bfffff",847,1746,2593
"1357",1970-01-01 06:00:00,"88a8a07461fffff",1018,2102,3120
"1358",1970-01-01 06:00:00,"88a8a07465fffff",854,1700,2554
"1359",1970-01-01 06:00:00,"88a8a07467fffff",51,150,201
"1360",1970-01-01 06:00:00,"88a8a07469fffff",102,300,402
"1361",1970-01-01 06:00:00,"88a8a0746bfffff",946,1967,2913
"1362",1970-01-01 06:00:00,"88a8a07503fffff",120,206,326
"1363",1970-01-01 06:00:00,"88a8a07507fffff",915,1768,2683
"1364",1970-01-01 06:00:00,"88a8a07509fffff",0,0,0
"1365",1970-01-01 06:00:00,"88a8a07515fffff",522,1021,1543
"1366",1970-01-01 06:00:00,"88a8a0751dfffff",162,403,565
"1367",1970-01-01 06:00:00,"88a8a07521fffff",1350,2597,3947
"1368",1970-01-01 06:00:00,"88a8a07525fffff",777,1541,2318
"1369",1970-01-01 06:00:00,"88a8a0752bfffff",1128,2206,3334
"1370",1970-01-01 06:00:00,"88a8a0752dfffff",1128,2091,3219
"1371",1970-01-01 06:00:00,"88a8a07531fffff",1179,2356,3535
"1372",1970-01-01 06:00:00,"88a8a07533fffff",240,412,652
"1373",1970-01-01 06:00:00,"88a8a07535fffff",639,1429,2068
"1374",1970-01-01 06:00:00,"88a8a07537fffff",180,309,489
"1375",1970-01-01 06:00:00,"88a8a07539fffff",1017,1953,2970
"1376",1970-01-01 06:00:00,"88a8a0753bfffff",171,356,527
"1377",1970-01-01 06:00:00,"88a8a0753dfffff",606,1300,1906
"1378",1970-01-01 06:00:00,"88a8a07543fffff",801,1551,2352
"1379",1970-01-01 06:00:00,"88a8a07545fffff",351,665,1016
"1380",1970-01-01 06:00:00,"88a8a07547fffff",732,1495,2227
"1381",1970-01-01 06:00:00,"88a8a07553fffff",162,403,565
"1382",1970-01-01 06:00:00,"88a8a07557fffff",51,150,201
"1383",1970-01-01 06:00:00,"88a8a07559fffff",921,1757,2678
"1384",1970-01-01 06:00:00,"88a8a0755bfffff",51,150,201
"1385",1970-01-01 06:00:00,"88a8a0755dfffff",921,1757,2678
"1386",1970-01-01 06:00:00,"88a8a07561fffff",1419,2768,4187
"1387",1970-01-01 06:00:00,"88a8a07565fffff",291,562,853
"1388",1970-01-01 06:00:00,"88a8a07567fffff",1239,2344,3583
"1389",1970-01-01 06:00:00,"88a8a07569fffff",624,1321,1945
"1390",1970-01-01 06:00:00,"88a8a0756bfffff",501,1036,1537
"1391",1970-01-01 06:00:00,"88a8a0756dfffff",1317,2583,3900
"1392",1970-01-01 06:00:00,"88a8a07633fffff",736,1493,2229
"1393",1970-01-01 06:00:00,"88a8a07637fffff",736,1493,2229
"1394",1970-01-01 06:00:00,"88a8a076c7fffff",321,612,933
"1395",1970-01-01 06:00:00,"88a8a076d1fffff",330,680,1010
"1396",1970-01-01 06:00:00,"88a8a076d3fffff",801,1551,2352
"1397",1970-01-01 06:00:00,"88a8a076d5fffff",672,1392,2064
"1398",1970-01-01 06:00:00,"88a8a076d7fffff",372,762,1134
"1399",1970-01-01 06:00:00,"88a8a076e9fffff",383,714,1097
"1400",1970-01-01 06:00:00,"88a8a076ebfffff",330,565,895
"1401",1970-01-01 06:00:00,"88a8a076edfffff",323,611,934
"1402",1970-01-01 06:30:00,"88a8a02801fffff",380,962,1342
"1403",1970-01-01 06:30:00,"88a8a02805fffff",128,291,419
"1404",1970-01-01 06:30:00,"88a8a02809fffff",0,0,0
"1405",1970-01-01 06:30:00,"88a8a0280bfffff",338,880,1218
"1406",1970-01-01 06:30:00,"88a8a02825fffff",53,149,202
"1407",1970-01-01 06:30:00,"88a8a02829fffff",86,209,295
"1408",1970-01-01 06:30:00,"88a8a0282dfffff",86,209,295
"1409",1970-01-01 06:30:00,"88a8a02853fffff",201,521,722
"1410",1970-01-01 06:30:00,"88a8a02857fffff",206,599,805
"1411",1970-01-01 06:30:00,"88a8a0291dfffff",33,60,93
"1412",1970-01-01 06:30:00,"88a8a02953fffff",33,60,93
"1413",1970-01-01 06:30:00,"88a8a02957fffff",33,60,93
"1414",1970-01-01 06:30:00,"88a8a02a01fffff",311,694,1005
"1415",1970-01-01 06:30:00,"88a8a02a05fffff",318,648,966
"1416",1970-01-01 06:30:00,"88a8a02a0bfffff",48,71,119
"1417",1970-01-01 06:30:00,"88a8a02a0dfffff",102,300,402
"1418",1970-01-01 06:30:00,"88a8a02a11fffff",53,149,202
"1419",1970-01-01 06:30:00,"88a8a02a13fffff",104,299,403
"1420",1970-01-01 06:30:00,"88a8a02a19fffff",161,323,484
"1421",1970-01-01 06:30:00,"88a8a02a57fffff",149,291,440
"1422",1970-01-01 06:30:00,"88a8a02a61fffff",204,485,689
"1423",1970-01-01 06:30:00,"88a8a02a63fffff",378,751,1129
"1424",1970-01-01 06:30:00,"88a8a02a69fffff",461,950,1411
"1425",1970-01-01 06:30:00,"88a8a02a6bfffff",111,253,364
"1426",1970-01-01 06:30:00,"88a8a02a89fffff",246,613,859
"1427",1970-01-01 06:30:00,"88a8a02a8bfffff",195,463,658
"1428",1970-01-01 06:30:00,"88a8a02a9dfffff",164,402,566
"1429",1970-01-01 06:30:00,"88a8a02aadfffff",251,591,842
"1430",1970-01-01 06:30:00,"88a8a02ac5fffff",263,623,886
"1431",1970-01-01 06:30:00,"88a8a02ac7fffff",398,983,1381
"1432",1970-01-01 06:30:00,"88a8a02ae3fffff",284,651,935
"1433",1970-01-01 06:30:00,"88a8a02ae7fffff",233,501,734
"1434",1970-01-01 06:30:00,"88a8a02aebfffff",284,651,935
"1435",1970-01-01 06:30:00,"88a8a03987fffff",60,103,163
"1436",1970-01-01 06:30:00,"88a8a03995fffff",423,912,1335
"1437",1970-01-01 06:30:00,"88a8a03997fffff",314,658,972
"1438",1970-01-01 06:30:00,"88a8a039a1fffff",333,644,977
"1439",1970-01-01 06:30:00,"88a8a039abfffff",386,793,1179
"1440",1970-01-01 06:30:00,"88a8a039adfffff",446,896,1342
"1441",1970-01-01 06:30:00,"88a8a039b9fffff",593,1188,1781
"1442",1970-01-01 06:30:00,"88a8a039bbfffff",589,1313,1902
"1443",1970-01-01 06:30:00,"88a8a039bdfffff",266,587,853
"1444",1970-01-01 06:30:00,"88a8a06081fffff",51,150,201
"1445",1970-01-01 06:30:00,"88a8a06085fffff",1188,2685,3873
"1446",1970-01-01 06:30:00,"88a8a0608dfffff",1173,2692,3865
"1447",1970-01-01 06:30:00,"88a8a060a3fffff",480,1242,1722
"1448",1970-01-01 06:30:00,"88a8a060a7fffff",102,300,402
"1449",1970-01-01 06:30:00,"88a8a060abfffff",411,956,1367
"1450",1970-01-01 06:30:00,"88a8a060c1fffff",153,335,488
"1451",1970-01-01 06:30:00,"88a8a060c3fffff",714,1525,2239
"1452",1970-01-01 06:30:00,"88a8a060c7fffff",537,1014,1551
"1453",1970-01-01 06:30:00,"88a8a060cbfffff",753,1553,2306
"1454",1970-01-01 06:30:00,"88a8a06193fffff",308,899,1207
"1455",1970-01-01 06:30:00,"88a8a06197fffff",104,299,403
"1456",1970-01-01 06:30:00,"88a8a0619bfffff",51,150,201
"1457",1970-01-01 06:30:00,"88a8a061a1fffff",206,599,805
"1458",1970-01-01 06:30:00,"88a8a061a3fffff",245,627,872
"1459",1970-01-01 06:30:00,"88a8a061a5fffff",243,628,871
"1460",1970-01-01 06:30:00,"88a8a061b1fffff",243,628,871
"1461",1970-01-01 06:30:00,"88a8a061b3fffff",389,1009,1398
"1462",1970-01-01 06:30:00,"88a8a061b5fffff",185,409,594
"1463",1970-01-01 06:30:00,"88a8a061b7fffff",386,955,1341
"1464",1970-01-01 06:30:00,"88a8a06249fffff",420,721,1141
"1465",1970-01-01 06:30:00,"88a8a0624bfffff",420,721,1141
"1466",1970-01-01 06:30:00,"88a8a0624dfffff",300,515,815
"1467",1970-01-01 06:30:00,"88a8a06281fffff",237,614,851
"1468",1970-01-01 06:30:00,"88a8a06283fffff",720,1654,2374
"1469",1970-01-01 06:30:00,"88a8a06287fffff",771,1689,2460
"1470",1970-01-01 06:30:00,"88a8a06289fffff",627,1422,2049
"1471",1970-01-01 06:30:00,"88a8a0628bfffff",357,820,1177
"1472",1970-01-01 06:30:00,"88a8a06293fffff",180,309,489
"1473",1970-01-01 06:30:00,"88a8a06299fffff",180,309,489
"1474",1970-01-01 06:30:00,"88a8a0629bfffff",240,412,652
"1475",1970-01-01 06:30:00,"88a8a062b5fffff",669,1389,2058
"1476",1970-01-01 06:30:00,"88a8a062bdfffff",660,1436,2096
"1477",1970-01-01 06:30:00,"88a8a062c1fffff",261,649,910
"1478",1970-01-01 06:30:00,"88a8a062c3fffff",531,1136,1667
"1479",1970-01-01 06:30:00,"88a8a062cbfffff",624,1368,1992
"1480",1970-01-01 06:30:00,"88a8a062d1fffff",180,309,489
"1481",1970-01-01 06:30:00,"88a8a062d3fffff",300,515,815
"1482",1970-01-01 06:30:00,"88a8a062d9fffff",180,309,489
"1483",1970-01-01 06:30:00,"88a8a06541fffff",120,206,326
"1484",1970-01-01 06:30:00,"88a8a06549fffff",240,412,652
"1485",1970-01-01 06:30:00,"88a8a06705fffff",120,206,326
"1486",1970-01-01 06:30:00,"88a8a06707fffff",120,206,326
"1487",1970-01-01 06:30:00,"88a8a0670dfffff",60,103,163
"1488",1970-01-01 06:30:00,"88a8a0672bfffff",180,309,489
"1489",1970-01-01 06:30:00,"88a8a06731fffff",240,412,652
"1490",1970-01-01 06:30:00,"88a8a06735fffff",300,515,815
"1491",1970-01-01 06:30:00,"88a8a06739fffff",240,412,652
"1492",1970-01-01 06:30:00,"88a8a0674dfffff",300,515,815
"1493",1970-01-01 06:30:00,"88a8a0676bfffff",120,206,326
"1494",1970-01-01 06:30:00,"88a8a06a91fffff",99,246,345
"1495",1970-01-01 06:30:00,"88a8a06a9bfffff",99,246,345
"1496",1970-01-01 06:30:00,"88a8a06e49fffff",387,1010,1397
"1497",1970-01-01 06:30:00,"88a8a06e4dfffff",489,1310,1799
"1498",1970-01-01 06:30:00,"88a8a06e69fffff",102,300,402
"1499",1970-01-01 06:30:00,"88a8a06e6dfffff",389,1009,1398
"1500",1970-01-01 06:30:00,"88a8a06f05fffff",51,150,201
"1501",1970-01-01 06:30:00,"88a8a06f63fffff",51,150,201
"1502",1970-01-01 06:30:00,"88a8a06f69fffff",102,300,402
"1503",1970-01-01 06:30:00,"88a8a070b3fffff",300,515,815
"1504",1970-01-01 06:30:00,"88a8a070b7fffff",420,721,1141
"1505",1970-01-01 06:30:00,"88a8a0719bfffff",180,309,489
"1506",1970-01-01 06:30:00,"88a8a07441fffff",672,1392,2064
"1507",1970-01-01 06:30:00,"88a8a07445fffff",453,965,1418
"1508",1970-01-01 06:30:00,"88a8a07447fffff",291,562,853
"1509",1970-01-01 06:30:00,"88a8a0744bfffff",624,1321,1945
"1510",1970-01-01 06:30:00,"88a8a07461fffff",735,1574,2309
"1511",1970-01-01 06:30:00,"88a8a07465fffff",624,1321,1945
"1512",1970-01-01 06:30:00,"88a8a07467fffff",120,206,326
"1513",1970-01-01 06:30:00,"88a8a07469fffff",60,103,163
"1514",1970-01-01 06:30:00,"88a8a0746bfffff",684,1424,2108
"1515",1970-01-01 06:30:00,"88a8a07503fffff",300,515,815
"1516",1970-01-01 06:30:00,"88a8a07507fffff",672,1302,1974
"1517",1970-01-01 06:30:00,"88a8a07515fffff",519,967,1486
"1518",1970-01-01 06:30:00,"88a8a0751dfffff",159,349,508
"1519",1970-01-01 06:30:00,"88a8a07521fffff",660,1410,2070
"1520",1970-01-01 06:30:00,"88a8a07525fffff",387,754,1141
"1521",1970-01-01 06:30:00,"88a8a0752bfffff",882,1801,2683
"1522",1970-01-01 06:30:00,"88a8a0752dfffff",717,1459,2176
"1523",1970-01-01 06:30:00,"88a8a07531fffff",1062,2272,3334
"1524",1970-01-01 06:30:00,"88a8a07533fffff",60,103,163
"1525",1970-01-01 06:30:00,"88a8a07535fffff",723,1614,2337
"1526",1970-01-01 06:30:00,"88a8a07537fffff",180,309,489
"1527",1970-01-01 06:30:00,"88a8a07539fffff",1068,2009,3077
"1528",1970-01-01 06:30:00,"88a8a0753bfffff",48,96,144
"1529",1970-01-01 06:30:00,"88a8a0753dfffff",543,1143,1686
"1530",1970-01-01 06:30:00,"88a8a07543fffff",612,1314,1926
"1531",1970-01-01 06:30:00,"88a8a07545fffff",582,1124,1706
"1532",1970-01-01 06:30:00,"88a8a07547fffff",972,1932,2904
"1533",1970-01-01 06:30:00,"88a8a07553fffff",60,103,163
"1534",1970-01-01 06:30:00,"88a8a07557fffff",159,349,508
"1535",1970-01-01 06:30:00,"88a8a07559fffff",783,1670,2453
"1536",1970-01-01 06:30:00,"88a8a0755bfffff",120,206,326
"1537",1970-01-01 06:30:00,"88a8a0755dfffff",663,1464,2127
"1538",1970-01-01 06:30:00,"88a8a07561fffff",762,1433,2195
"1539",1970-01-01 06:30:00,"88a8a07565fffff",0,0,0
"1540",1970-01-01 06:30:00,"88a8a07567fffff",675,1262,1937
"1541",1970-01-01 06:30:00,"88a8a07569fffff",873,1686,2559
"1542",1970-01-01 06:30:00,"88a8a0756bfffff",519,967,1486
"1543",1970-01-01 06:30:00,"88a8a0756dfffff",1149,2187,3336
"1544",1970-01-01 06:30:00,"88a8a07633fffff",786,1724,2510
"1545",1970-01-01 06:30:00,"88a8a07637fffff",675,1471,2146
"1546",1970-01-01 06:30:00,"88a8a076c7fffff",326,805,1131
"1547",1970-01-01 06:30:00,"88a8a076d1fffff",162,288,450
"1548",1970-01-01 06:30:00,"88a8a076d3fffff",545,1117,1662
"1549",1970-01-01 06:30:00,"88a8a076d5fffff",372,762,1134
"1550",1970-01-01 06:30:00,"88a8a076d7fffff",305,705,1010
"1551",1970-01-01 06:30:00,"88a8a076e9fffff",441,933,1374
"1552",1970-01-01 06:30:00,"88a8a076ebfffff",273,656,929
"1553",1970-01-01 06:30:00,"88a8a076edfffff",393,862,1255
"1554",1970-01-01 07:00:00,"88a8a02801fffff",156,298,454
"1555",1970-01-01 07:00:00,"88a8a02805fffff",75,142,217
"1556",1970-01-01 07:00:00,"88a8a02809fffff",33,60,93
"1557",1970-01-01 07:00:00,"88a8a0280bfffff",123,238,361
"1558",1970-01-01 07:00:00,"88a8a02825fffff",33,60,93
"1559",1970-01-01 07:00:00,"88a8a02829fffff",75,142,217
"1560",1970-01-01 07:00:00,"88a8a0282dfffff",75,142,217
"1561",1970-01-01 07:00:00,"88a8a02853fffff",264,541,805
"1562",1970-01-01 07:00:00,"88a8a02857fffff",180,377,557
"1563",1970-01-01 07:00:00,"88a8a0291dfffff",42,82,124
"1564",1970-01-01 07:00:00,"88a8a02953fffff",75,142,217
"1565",1970-01-01 07:00:00,"88a8a02957fffff",33,60,93
"1566",1970-01-01 07:00:00,"88a8a02a01fffff",300,627,927
"1567",1970-01-01 07:00:00,"88a8a02a05fffff",408,916,1324
"1568",1970-01-01 07:00:00,"88a8a02a0bfffff",147,292,439
"1569",1970-01-01 07:00:00,"88a8a02a0dfffff",99,221,320
"1570",1970-01-01 07:00:00,"88a8a02a11fffff",374,876,1250
"1571",1970-01-01 07:00:00,"88a8a02a13fffff",323,726,1049
"1572",1970-01-01 07:00:00,"88a8a02a19fffff",410,915,1325
"1573",1970-01-01 07:00:00,"88a8a02a57fffff",350,812,1162
"1574",1970-01-01 07:00:00,"88a8a02a61fffff",51,150,201
"1575",1970-01-01 07:00:00,"88a8a02a63fffff",210,474,684
"1576",1970-01-01 07:00:00,"88a8a02a69fffff",363,924,1287
"1577",1970-01-01 07:00:00,"88a8a02a6bfffff",60,103,163
"1578",1970-01-01 07:00:00,"88a8a02a89fffff",425,1051,1476
"1579",1970-01-01 07:00:00,"88a8a02a8bfffff",374,901,1275
"1580",1970-01-01 07:00:00,"88a8a02a9dfffff",312,799,1111
"1581",1970-01-01 07:00:00,"88a8a02aa9fffff",90,153,243
"1582",1970-01-01 07:00:00,"88a8a02aadfffff",231,527,758
"1583",1970-01-01 07:00:00,"88a8a02ac5fffff",428,1105,1533
"1584",1970-01-01 07:00:00,"88a8a02ac7fffff",575,1422,1997
"1585",1970-01-01 07:00:00,"88a8a02ae3fffff",198,467,665
"1586",1970-01-01 07:00:00,"88a8a02ae7fffff",231,527,758
"1587",1970-01-01 07:00:00,"88a8a02aebfffff",198,467,665
"1588",1970-01-01 07:00:00,"88a8a03987fffff",443,957,1400
"1589",1970-01-01 07:00:00,"88a8a03995fffff",591,1214,1805
"1590",1970-01-01 07:00:00,"88a8a03997fffff",516,1259,1775
"1591",1970-01-01 07:00:00,"88a8a039a1fffff",1064,2199,3263
"1592",1970-01-01 07:00:00,"88a8a039abfffff",1217,2534,3751
"1593",1970-01-01 07:00:00,"88a8a039adfffff",1163,2305,3468
"1594",1970-01-01 07:00:00,"88a8a039b9fffff",1268,2684,3952
"1595",1970-01-01 07:00:00,"88a8a039bbfffff",756,1671,2427
"1596",1970-01-01 07:00:00,"88a8a039bdfffff",402,815,1217
"1597",1970-01-01 07:00:00,"88a8a06081fffff",0,0,0
"1598",1970-01-01 07:00:00,"88a8a06085fffff",850,2243,3093
"1599",1970-01-01 07:00:00,"88a8a0608dfffff",1132,2669,3801
"1600",1970-01-01 07:00:00,"88a8a060a3fffff",542,1459,2001
"1601",1970-01-01 07:00:00,"88a8a060a7fffff",93,232,325
"1602",1970-01-01 07:00:00,"88a8a060abfffff",512,1384,1896
"1603",1970-01-01 07:00:00,"88a8a060c1fffff",155,334,489
"1604",1970-01-01 07:00:00,"88a8a060c3fffff",662,1665,2327
"1605",1970-01-01 07:00:00,"88a8a060c7fffff",731,1721,2452
"1606",1970-01-01 07:00:00,"88a8a060cbfffff",719,1714,2433
"1607",1970-01-01 07:00:00,"88a8a06193fffff",531,1392,1923
"1608",1970-01-01 07:00:00,"88a8a06197fffff",246,682,928
"1609",1970-01-01 07:00:00,"88a8a0619bfffff",195,532,727
"1610",1970-01-01 07:00:00,"88a8a061a1fffff",294,778,1072
"1611",1970-01-01 07:00:00,"88a8a061a3fffff",345,928,1273
"1612",1970-01-01 07:00:00,"88a8a061a5fffff",333,794,1127
"1613",1970-01-01 07:00:00,"88a8a061b1fffff",303,846,1149
"1614",1970-01-01 07:00:00,"88a8a061b3fffff",507,1331,1838
"1615",1970-01-01 07:00:00,"88a8a061b5fffff",507,1331,1838
"1616",1970-01-01 07:00:00,"88a8a061b7fffff",618,1584,2202
"1617",1970-01-01 07:00:00,"88a8a06249fffff",360,618,978
"1618",1970-01-01 07:00:00,"88a8a0624bfffff",360,618,978
"1619",1970-01-01 07:00:00,"88a8a0624dfffff",600,1030,1630
"1620",1970-01-01 07:00:00,"88a8a06281fffff",381,740,1121
"1621",1970-01-01 07:00:00,"88a8a06283fffff",708,1532,2240
"1622",1970-01-01 07:00:00,"88a8a06287fffff",648,1544,2192
"1623",1970-01-01 07:00:00,"88a8a06289fffff",816,1731,2547
"1624",1970-01-01 07:00:00,"88a8a0628bfffff",456,1066,1522
"1625",1970-01-01 07:00:00,"88a8a06293fffff",60,103,163
"1626",1970-01-01 07:00:00,"88a8a06299fffff",60,103,163
"1627",1970-01-01 07:00:00,"88a8a0629bfffff",60,103,163
"1628",1970-01-01 07:00:00,"88a8a062b5fffff",761,1796,2557
"1629",1970-01-01 07:00:00,"88a8a062bdfffff",666,1565,2231
"1630",1970-01-01 07:00:00,"88a8a062c1fffff",405,916,1321
"1631",1970-01-01 07:00:00,"88a8a062c3fffff",636,1307,1943
"1632",1970-01-01 07:00:00,"88a8a062cbfffff",756,1628,2384
"1633",1970-01-01 07:00:00,"88a8a062d1fffff",180,309,489
"1634",1970-01-01 07:00:00,"88a8a062d3fffff",240,412,652
"1635",1970-01-01 07:00:00,"88a8a062d9fffff",300,515,815
"1636",1970-01-01 07:00:00,"88a8a06541fffff",60,103,163
"1637",1970-01-01 07:00:00,"88a8a06549fffff",120,206,326
"1638",1970-01-01 07:00:00,"88a8a06705fffff",420,721,1141
"1639",1970-01-01 07:00:00,"88a8a06707fffff",180,309,489
"1640",1970-01-01 07:00:00,"88a8a0670dfffff",360,618,978
"1641",1970-01-01 07:00:00,"88a8a0672bfffff",180,309,489
"1642",1970-01-01 07:00:00,"88a8a06731fffff",60,103,163
"1643",1970-01-01 07:00:00,"88a8a06735fffff",120,206,326
"1644",1970-01-01 07:00:00,"88a8a06739fffff",180,309,489
"1645",1970-01-01 07:00:00,"88a8a0673dfffff",120,206,326
"1646",1970-01-01 07:00:00,"88a8a0674dfffff",60,103,163
"1647",1970-01-01 07:00:00,"88a8a0676bfffff",360,618,978
"1648",1970-01-01 07:00:00,"88a8a06a91fffff",192,466,658
"1649",1970-01-01 07:00:00,"88a8a06a9bfffff",192,478,670
"1650",1970-01-01 07:00:00,"88a8a06e49fffff",449,1227,1676
"1651",1970-01-01 07:00:00,"88a8a06e4bfffff",0,0,0
"1652",1970-01-01 07:00:00,"88a8a06e4dfffff",575,1473,2048
"1653",1970-01-01 07:00:00,"88a8a06e69fffff",204,600,804
"1654",1970-01-01 07:00:00,"88a8a06e6dfffff",498,1378,1876
"1655",1970-01-01 07:00:00,"88a8a070b3fffff",360,618,978
"1656",1970-01-01 07:00:00,"88a8a070b7fffff",420,721,1141
"1657",1970-01-01 07:00:00,"88a8a0719bfffff",420,721,1141
"1658",1970-01-01 07:00:00,"88a8a07441fffff",852,1726,2578
"1659",1970-01-01 07:00:00,"88a8a07445fffff",522,1021,1543
"1660",1970-01-01 07:00:00,"88a8a07447fffff",330,705,1035
"1661",1970-01-01 07:00:00,"88a8a0744bfffff",852,1726,2578
"1662",1970-01-01 07:00:00,"88a8a07461fffff",1053,2157,3210
"1663",1970-01-01 07:00:00,"88a8a07465fffff",1140,2209,3349
"1664",1970-01-01 07:00:00,"88a8a07467fffff",150,281,431
"1665",1970-01-01 07:00:00,"88a8a07469fffff",138,274,412
"1666",1970-01-01 07:00:00,"88a8a0746bfffff",993,2054,3047
"1667",1970-01-01 07:00:00,"88a8a07507fffff",879,1726,2605
"1668",1970-01-01 07:00:00,"88a8a07509fffff",0,0,0
"1669",1970-01-01 07:00:00,"88a8a07515fffff",621,1152,1773
"1670",1970-01-01 07:00:00,"88a8a0751dfffff",201,431,632
"1671",1970-01-01 07:00:00,"88a8a07521fffff",1059,2035,3094
"1672",1970-01-01 07:00:00,"88a8a07525fffff",666,1288,1954
"1673",1970-01-01 07:00:00,"88a8a0752bfffff",1110,2185,3295
"1674",1970-01-01 07:00:00,"88a8a0752dfffff",1170,2288,3458
"1675",1970-01-01 07:00:00,"88a8a07531fffff",1230,2438,3668
"1676",1970-01-01 07:00:00,"88a8a07533fffff",240,412,652
"1677",1970-01-01 07:00:00,"88a8a07535fffff",708,1532,2240
"1678",1970-01-01 07:00:00,"88a8a07537fffff",300,515,815
"1679",1970-01-01 07:00:00,"88a8a07539fffff",1194,2323,3517
"1680",1970-01-01 07:00:00,"88a8a0753bfffff",60,103,163
"1681",1970-01-01 07:00:00,"88a8a0753dfffff",297,717,1014
"1682",1970-01-01 07:00:00,"88a8a07543fffff",993,1892,2885
"1683",1970-01-01 07:00:00,"88a8a07545fffff",771,1386,2157
"1684",1970-01-01 07:00:00,"88a8a07547fffff",873,1686,2559
"1685",1970-01-01 07:00:00,"88a8a07553fffff",108,199,307
"1686",1970-01-01 07:00:00,"88a8a07557fffff",153,335,488
"1687",1970-01-01 07:00:00,"88a8a07559fffff",993,1892,2885
"1688",1970-01-01 07:00:00,"88a8a0755bfffff",150,281,431
"1689",1970-01-01 07:00:00,"88a8a0755dfffff",993,1892,2885
"1690",1970-01-01 07:00:00,"88a8a07561fffff",786,1609,2395
"1691",1970-01-01 07:00:00,"88a8a07565fffff",102,185,287
"1692",1970-01-01 07:00:00,"88a8a07567fffff",1119,2138,3257
"1693",1970-01-01 07:00:00,"88a8a07569fffff",822,1536,2358
"1694",1970-01-01 07:00:00,"88a8a0756bfffff",462,918,1380
"1695",1970-01-01 07:00:00,"88a8a0756dfffff",1257,2365,3622
"1696",1970-01-01 07:00:00,"88a8a07633fffff",903,1761,2664
"1697",1970-01-01 07:00:00,"88a8a07637fffff",912,1829,2741
"1698",1970-01-01 07:00:00,"88a8a076c7fffff",492,993,1485
"1699",1970-01-01 07:00:00,"88a8a076d1fffff",767,1623,2390
"1700",1970-01-01 07:00:00,"88a8a076d3fffff",1205,2502,3707
"1701",1970-01-01 07:00:00,"88a8a076d5fffff",602,1256,1858
"1702",1970-01-01 07:00:00,"88a8a076d7fffff",330,680,1010
"1703",1970-01-01 07:00:00,"88a8a076e9fffff",816,1684,2500
"1704",1970-01-01 07:00:00,"88a8a076ebfffff",384,794,1178
"1705",1970-01-01 07:00:00,"88a8a076edfffff",996,1993,2989
"1706",1970-01-01 07:30:00,"88a8a02801fffff",86,209,295
"1707",1970-01-01 07:30:00,"88a8a02805fffff",33,60,93
"1708",1970-01-01 07:30:00,"88a8a02809fffff",0,0,0
"1709",1970-01-01 07:30:00,"88a8a0280bfffff",53,149,202
"1710",1970-01-01 07:30:00,"88a8a02829fffff",33,60,93
"1711",1970-01-01 07:30:00,"88a8a0282dfffff",33,60,93
"1712",1970-01-01 07:30:00,"88a8a02853fffff",53,149,202
"1713",1970-01-01 07:30:00,"88a8a02857fffff",53,149,202
"1714",1970-01-01 07:30:00,"88a8a0291dfffff",42,82,124
"1715",1970-01-01 07:30:00,"88a8a02953fffff",33,60,93
"1716",1970-01-01 07:30:00,"88a8a02957fffff",75,142,217
"1717",1970-01-01 07:30:00,"88a8a02a01fffff",303,706,1009
"1718",1970-01-01 07:30:00,"88a8a02a05fffff",354,856,1210
"1719",1970-01-01 07:30:00,"88a8a02a09fffff",0,0,0
"1720",1970-01-01 07:30:00,"88a8a02a0bfffff",108,174,282
"1721",1970-01-01 07:30:00,"88a8a02a0dfffff",171,356,527
"1722",1970-01-01 07:30:00,"88a8a02a11fffff",264,703,967
"1723",1970-01-01 07:30:00,"88a8a02a13fffff",366,1003,1369
"1724",1970-01-01 07:30:00,"88a8a02a19fffff",333,759,1092
"1725",1970-01-01 07:30:00,"88a8a02a57fffff",279,530,809
"1726",1970-01-01 07:30:00,"88a8a02a61fffff",141,303,444
"1727",1970-01-01 07:30:00,"88a8a02a63fffff",402,927,1329
"1728",1970-01-01 07:30:00,"88a8a02a69fffff",423,912,1335
"1729",1970-01-01 07:30:00,"88a8a02a6bfffff",51,150,201
"1730",1970-01-01 07:30:00,"88a8a02a89fffff",432,1123,1555
"1731",1970-01-01 07:30:00,"88a8a02a8bfffff",432,1123,1555
"1732",1970-01-01 07:30:00,"88a8a02a9dfffff",186,510,696
"1733",1970-01-01 07:30:00,"88a8a02aadfffff",53,149,202
"1734",1970-01-01 07:30:00,"88a8a02ac5fffff",315,853,1168
"1735",1970-01-01 07:30:00,"88a8a02ac7fffff",452,1212,1664
"1736",1970-01-01 07:30:00,"88a8a02ae3fffff",86,209,295
"1737",1970-01-01 07:30:00,"88a8a02ae7fffff",53,149,202
"1738",1970-01-01 07:30:00,"88a8a02aebfffff",86,209,295
"1739",1970-01-01 07:30:00,"88a8a03987fffff",219,427,646
"1740",1970-01-01 07:30:00,"88a8a03995fffff",351,665,1016
"1741",1970-01-01 07:30:00,"88a8a03997fffff",321,727,1048
"1742",1970-01-01 07:30:00,"88a8a039a1fffff",489,1029,1518
"1743",1970-01-01 07:30:00,"88a8a039abfffff",612,1289,1901
"1744",1970-01-01 07:30:00,"88a8a039adfffff",713,1534,2247
"1745",1970-01-01 07:30:00,"88a8a039b9fffff",513,1068,1581
"1746",1970-01-01 07:30:00,"88a8a039bbfffff",660,1360,2020
"1747",1970-01-01 07:30:00,"88a8a039bdfffff",60,103,163
"1748",1970-01-01 07:30:00,"88a8a06081fffff",48,96,144
"1749",1970-01-01 07:30:00,"88a8a06085fffff",840,1907,2747
"1750",1970-01-01 07:30:00,"88a8a0608dfffff",1101,2441,3542
"1751",1970-01-01 07:30:00,"88a8a060a3fffff",399,1132,1531
"1752",1970-01-01 07:30:00,"88a8a060a7fffff",51,150,201
"1753",1970-01-01 07:30:00,"88a8a060abfffff",405,1031,1436
"1754",1970-01-01 07:30:00,"88a8a060c1fffff",141,328,469
"1755",1970-01-01 07:30:00,"88a8a060c3fffff",546,1129,1675
"1756",1970-01-01 07:30:00,"88a8a060c7fffff",774,1649,2423
"1757",1970-01-01 07:30:00,"88a8a060cbfffff",816,1846,2662
"1758",1970-01-01 07:30:00,"88a8a06193fffff",408,1085,1493
"1759",1970-01-01 07:30:00,"88a8a06197fffff",153,335,488
"1760",1970-01-01 07:30:00,"88a8a0619bfffff",51,150,201
"1761",1970-01-01 07:30:00,"88a8a061a1fffff",248,681,929
"1762",1970-01-01 07:30:00,"88a8a061a3fffff",155,449,604
"1763",1970-01-01 07:30:00,"88a8a061a5fffff",153,450,603
"1764",1970-01-01 07:30:00,"88a8a061b1fffff",102,300,402
"1765",1970-01-01 07:30:00,"88a8a061b3fffff",257,634,891
"1766",1970-01-01 07:30:00,"88a8a061b5fffff",155,449,604
"1767",1970-01-01 07:30:00,"88a8a061b7fffff",299,831,1130
"1768",1970-01-01 07:30:00,"88a8a06213fffff",0,0,0
"1769",1970-01-01 07:30:00,"88a8a0621bfffff",0,0,0
"1770",1970-01-01 07:30:00,"88a8a06249fffff",780,1339,2119
"1771",1970-01-01 07:30:00,"88a8a0624bfffff",642,1112,1754
"1772",1970-01-01 07:30:00,"88a8a0624dfffff",660,1133,1793
"1773",1970-01-01 07:30:00,"88a8a06281fffff",491,1079,1570
"1774",1970-01-01 07:30:00,"88a8a06283fffff",938,2192,3130
"1775",1970-01-01 07:30:00,"88a8a06285fffff",0,0,0
"1776",1970-01-01 07:30:00,"88a8a06287fffff",956,2213,3169
"1777",1970-01-01 07:30:00,"88a8a06289fffff",848,2014,2862
"1778",1970-01-01 07:30:00,"88a8a0628bfffff",285,595,880
"1779",1970-01-01 07:30:00,"88a8a06293fffff",240,412,652
"1780",1970-01-01 07:30:00,"88a8a06299fffff",240,412,652
"1781",1970-01-01 07:30:00,"88a8a0629bfffff",120,206,326
"1782",1970-01-01 07:30:00,"88a8a062a9fffff",0,0,0
"1783",1970-01-01 07:30:00,"88a8a062abfffff",0,0,0
"1784",1970-01-01 07:30:00,"88a8a062b5fffff",867,1996,2863
"1785",1970-01-01 07:30:00,"88a8a062bdfffff",1055,2459,3514
"1786",1970-01-01 07:30:00,"88a8a062c1fffff",213,553,766
"1787",1970-01-01 07:30:00,"88a8a062c3fffff",797,1864,2661
"1788",1970-01-01 07:30:00,"88a8a062c5fffff",0,0,0
"1789",1970-01-01 07:30:00,"88a8a062cbfffff",707,1571,2278
"1790",1970-01-01 07:30:00,"88a8a062d1fffff",300,515,815
"1791",1970-01-01 07:30:00,"88a8a062d3fffff",240,412,652
"1792",1970-01-01 07:30:00,"88a8a062d9fffff",300,515,815
"1793",1970-01-01 07:30:00,"88a8a062e3fffff",0,0,0
"1794",1970-01-01 07:30:00,"88a8a062ebfffff",0,0,0
"1795",1970-01-01 07:30:00,"88a8a06541fffff",180,309,489
"1796",1970-01-01 07:30:00,"88a8a06549fffff",240,412,652
"1797",1970-01-01 07:30:00,"88a8a06705fffff",300,515,815
"1798",1970-01-01 07:30:00,"88a8a06707fffff",180,309,489
"1799",1970-01-01 07:30:00,"88a8a0670dfffff",180,309,489
"1800",1970-01-01 07:30:00,"88a8a0672bfffff",120,206,326
"1801",1970-01-01 07:30:00,"88a8a06731fffff",120,206,326
"1802",1970-01-01 07:30:00,"88a8a06735fffff",240,412,652
"1803",1970-01-01 07:30:00,"88a8a06739fffff",180,309,489
"1804",1970-01-01 07:30:00,"88a8a0674dfffff",180,309,489
"1805",1970-01-01 07:30:00,"88a8a0676bfffff",180,309,489
"1806",1970-01-01 07:30:00,"88a8a06a91fffff",102,300,402
"1807",1970-01-01 07:30:00,"88a8a06a9bfffff",102,300,402
"1808",1970-01-01 07:30:00,"88a8a06e49fffff",348,982,1330
"1809",1970-01-01 07:30:00,"88a8a06e4dfffff",408,1085,1493
"1810",1970-01-01 07:30:00,"88a8a06e69fffff",102,300,402
"1811",1970-01-01 07:30:00,"88a8a06e6dfffff",204,485,689
"1812",1970-01-01 07:30:00,"88a8a06f05fffff",102,300,402
"1813",1970-01-01 07:30:00,"88a8a06f61fffff",51,150,201
"1814",1970-01-01 07:30:00,"88a8a06f63fffff",51,150,201
"1815",1970-01-01 07:30:00,"88a8a06f67fffff",102,300,402
"1816",1970-01-01 07:30:00,"88a8a06f69fffff",51,150,201
"1817",1970-01-01 07:30:00,"88a8a070b3fffff",642,1112,1754
"1818",1970-01-01 07:30:00,"88a8a070b7fffff",582,1009,1591
"1819",1970-01-01 07:30:00,"88a8a0719bfffff",180,309,489
"1820",1970-01-01 07:30:00,"88a8a07441fffff",1064,2174,3238
"1821",1970-01-01 07:30:00,"88a8a07445fffff",501,1036,1537
"1822",1970-01-01 07:30:00,"88a8a07447fffff",741,1448,2189
"1823",1970-01-01 07:30:00,"88a8a0744bfffff",968,2032,3000
"1824",1970-01-01 07:30:00,"88a8a07461fffff",1137,2386,3523
"1825",1970-01-01 07:30:00,"88a8a07465fffff",840,1669,2509
"1826",1970-01-01 07:30:00,"88a8a07467fffff",195,417,612
"1827",1970-01-01 07:30:00,"88a8a07469fffff",222,506,728
"1828",1970-01-01 07:30:00,"88a8a0746bfffff",1215,2510,3725
"1829",1970-01-01 07:30:00,"88a8a07503fffff",120,206,326
"1830",1970-01-01 07:30:00,"88a8a07507fffff",891,1754,2645
"1831",1970-01-01 07:30:00,"88a8a07515fffff",684,1194,1878
"1832",1970-01-01 07:30:00,"88a8a0751dfffff",195,417,612
"1833",1970-01-01 07:30:00,"88a8a07521fffff",1259,2526,3785
"1834",1970-01-01 07:30:00,"88a8a07525fffff",848,1596,2444
"1835",1970-01-01 07:30:00,"88a8a0752bfffff",1199,2423,3622
"1836",1970-01-01 07:30:00,"88a8a0752dfffff",1268,2479,3747
"1837",1970-01-01 07:30:00,"88a8a07531fffff",1175,2388,3563
"1838",1970-01-01 07:30:00,"88a8a07533fffff",120,206,326
"1839",1970-01-01 07:30:00,"88a8a07535fffff",689,1550,2239
"1840",1970-01-01 07:30:00,"88a8a07537fffff",240,412,652
"1841",1970-01-01 07:30:00,"88a8a07539fffff",1502,2877,4379
"1842",1970-01-01 07:30:00,"88a8a0753bfffff",144,267,411
"1843",1970-01-01 07:30:00,"88a8a0753dfffff",407,915,1322
"1844",1970-01-01 07:30:00,"88a8a07543fffff",783,1361,2144
"1845",1970-01-01 07:30:00,"88a8a07545fffff",471,871,1342
"1846",1970-01-01 07:30:00,"88a8a07547fffff",687,1219,1906
"1847",1970-01-01 07:30:00,"88a8a07553fffff",195,417,612
"1848",1970-01-01 07:30:00,"88a8a07557fffff",153,335,488
"1849",1970-01-01 07:30:00,"88a8a07559fffff",684,1140,1824
"1850",1970-01-01 07:30:00,"88a8a0755bfffff",195,417,612
"1851",1970-01-01 07:30:00,"88a8a0755dfffff",735,1290,2025
"1852",1970-01-01 07:30:00,"88a8a07561fffff",1125,2152,3277
"1853",1970-01-01 07:30:00,"88a8a07565fffff",180,309,489
"1854",1970-01-01 07:30:00,"88a8a07567fffff",1379,2732,4111
"1855",1970-01-01 07:30:00,"88a8a07569fffff",531,974,1505
"1856",1970-01-01 07:30:00,"88a8a0756bfffff",507,910,1417
"1857",1970-01-01 07:30:00,"88a8a0756dfffff",1230,2247,3477
"1858",1970-01-01 07:30:00,"88a8a07633fffff",686,1423,2109
"1859",1970-01-01 07:30:00,"88a8a07637fffff",857,1779,2636
"1860",1970-01-01 07:30:00,"88a8a076c7fffff",224,505,729
"1861",1970-01-01 07:30:00,"88a8a076d1fffff",602,1281,1883
"1862",1970-01-01 07:30:00,"88a8a076d3fffff",944,1993,2937
"1863",1970-01-01 07:30:00,"88a8a076d5fffff",602,1281,1883
"1864",1970-01-01 07:30:00,"88a8a076d7fffff",162,403,565
"1865",1970-01-01 07:30:00,"88a8a076e9fffff",291,562,853
"1866",1970-01-01 07:30:00,"88a8a076ebfffff",231,459,690
"1867",1970-01-01 07:30:00,"88a8a076edfffff",351,665,1016
"1868",1970-01-01 08:00:00,"88a8a02801fffff",117,270,387
"1869",1970-01-01 08:00:00,"88a8a02805fffff",66,120,186
"1870",1970-01-01 08:00:00,"88a8a02809fffff",0,0,0
"1871",1970-01-01 08:00:00,"88a8a0280bfffff",159,352,511
"1872",1970-01-01 08:00:00,"88a8a02825fffff",33,60,93
"1873",1970-01-01 08:00:00,"88a8a02829fffff",66,120,186
"1874",1970-01-01 08:00:00,"88a8a0282dfffff",108,202,310
"1875",1970-01-01 08:00:00,"88a8a02853fffff",66,120,186
"1876",1970-01-01 08:00:00,"88a8a02857fffff",159,352,511
"1877",1970-01-01 08:00:00,"88a8a02919fffff",75,142,217
"1878",1970-01-01 08:00:00,"88a8a0291dfffff",66,120,186
"1879",1970-01-01 08:00:00,"88a8a02953fffff",108,202,310
"1880",1970-01-01 08:00:00,"88a8a02957fffff",33,60,93
"1881",1970-01-01 08:00:00,"88a8a02a01fffff",315,738,1053
"1882",1970-01-01 08:00:00,"88a8a02a05fffff",425,1051,1476
"1883",1970-01-01 08:00:00,"88a8a02a0bfffff",153,335,488
"1884",1970-01-01 08:00:00,"88a8a02a0dfffff",51,150,201
"1885",1970-01-01 08:00:00,"88a8a02a11fffff",99,246,345
"1886",1970-01-01 08:00:00,"88a8a02a13fffff",245,627,872
"1887",1970-01-01 08:00:00,"88a8a02a19fffff",245,627,872
"1888",1970-01-01 08:00:00,"88a8a02a57fffff",155,449,604
"1889",1970-01-01 08:00:00,"88a8a02a61fffff",159,349,508
"1890",1970-01-01 08:00:00,"88a8a02a63fffff",374,901,1275
"1891",1970-01-01 08:00:00,"88a8a02a69fffff",587,1454,2041
"1892",1970-01-01 08:00:00,"88a8a02a6bfffff",102,300,402
"1893",1970-01-01 08:00:00,"88a8a02a89fffff",201,546,747
"1894",1970-01-01 08:00:00,"88a8a02a8bfffff",201,546,747
"1895",1970-01-01 08:00:00,"88a8a02a9dfffff",102,300,402
"1896",1970-01-01 08:00:00,"88a8a02aa9fffff",33,60,93
"1897",1970-01-01 08:00:00,"88a8a02aadfffff",75,142,217
"1898",1970-01-01 08:00:00,"88a8a02ac5fffff",144,382,526
"1899",1970-01-01 08:00:00,"88a8a02ac7fffff",174,388,562
"1900",1970-01-01 08:00:00,"88a8a02ae3fffff",33,60,93
"1901",1970-01-01 08:00:00,"88a8a02ae7fffff",75,142,217
"1902",1970-01-01 08:00:00,"88a8a02aebfffff",75,142,217
"1903",1970-01-01 08:00:00,"88a8a03987fffff",543,1118,1661
"1904",1970-01-01 08:00:00,"88a8a03995fffff",653,1431,2084
"1905",1970-01-01 08:00:00,"88a8a03997fffff",587,1454,2041
"1906",1970-01-01 08:00:00,"88a8a039a1fffff",818,1773,2591
"1907",1970-01-01 08:00:00,"88a8a039abfffff",1037,2225,3262
"1908",1970-01-01 08:00:00,"88a8a039adfffff",1136,2446,3582
"1909",1970-01-01 08:00:00,"88a8a039b9fffff",893,1818,2711
"1910",1970-01-01 08:00:00,"88a8a039bbfffff",815,1834,2649
"1911",1970-01-01 08:00:00,"88a8a039bdfffff",108,199,307
"1912",1970-01-01 08:00:00,"88a8a06085fffff",602,1332,1934
"1913",1970-01-01 08:00:00,"88a8a0608dfffff",847,1844,2691
"1914",1970-01-01 08:00:00,"88a8a060a3fffff",377,955,1332
"1915",1970-01-01 08:00:00,"88a8a060abfffff",266,702,968
"1916",1970-01-01 08:00:00,"88a8a060c1fffff",60,103,163
"1917",1970-01-01 08:00:00,"88a8a060c3fffff",965,2051,3016
"1918",1970-01-01 08:00:00,"88a8a060c7fffff",905,2063,2968
"1919",1970-01-01 08:00:00,"88a8a060cbfffff",905,1948,2853
"1920",1970-01-01 08:00:00,"88a8a06193fffff",368,1002,1370
"1921",1970-01-01 08:00:00,"88a8a06197fffff",206,599,805
"1922",1970-01-01 08:00:00,"88a8a0619bfffff",60,103,163
"1923",1970-01-01 08:00:00,"88a8a061a1fffff",153,450,603
"1924",1970-01-01 08:00:00,"88a8a061a3fffff",204,600,804
"1925",1970-01-01 08:00:00,"88a8a061a5fffff",155,449,604
"1926",1970-01-01 08:00:00,"88a8a061b1fffff",102,300,402
"1927",1970-01-01 08:00:00,"88a8a061b3fffff",366,1003,1369
"1928",1970-01-01 08:00:00,"88a8a061b5fffff",264,703,967
"1929",1970-01-01 08:00:00,"88a8a061b7fffff",537,1359,1896
"1930",1970-01-01 08:00:00,"88a8a06249fffff",426,761,1187
"1931",1970-01-01 08:00:00,"88a8a0624bfffff",555,1035,1590
"1932",1970-01-01 08:00:00,"88a8a0624dfffff",726,1276,2002
"1933",1970-01-01 08:00:00,"88a8a06281fffff",411,930,1341
"1934",1970-01-01 08:00:00,"88a8a06283fffff",723,1614,2337
"1935",1970-01-01 08:00:00,"88a8a06287fffff",672,1464,2136
"1936",1970-01-01 08:00:00,"88a8a06289fffff",699,1579,2278
"1937",1970-01-01 08:00:00,"88a8a0628bfffff",348,867,1215
"1938",1970-01-01 08:00:00,"88a8a06293fffff",180,309,489
"1939",1970-01-01 08:00:00,"88a8a06299fffff",293,561,854
"1940",1970-01-01 08:00:00,"88a8a0629bfffff",293,561,854
"1941",1970-01-01 08:00:00,"88a8a062b5fffff",852,1799,2651
"1942",1970-01-01 08:00:00,"88a8a062bdfffff",708,1532,2240
"1943",1970-01-01 08:00:00,"88a8a062c1fffff",345,928,1273
"1944",1970-01-01 08:00:00,"88a8a062c3fffff",717,1600,2317
"1945",1970-01-01 08:00:00,"88a8a062cbfffff",807,1778,2585
"1946",1970-01-01 08:00:00,"88a8a062d1fffff",413,767,1180
"1947",1970-01-01 08:00:00,"88a8a062d3fffff",353,664,1017
"1948",1970-01-01 08:00:00,"88a8a062d9fffff",360,618,978
"1949",1970-01-01 08:00:00,"88a8a06541fffff",120,206,326
"1950",1970-01-01 08:00:00,"88a8a06549fffff",180,309,489
"1951",1970-01-01 08:00:00,"88a8a06705fffff",240,412,652
"1952",1970-01-01 08:00:00,"88a8a06707fffff",180,309,489
"1953",1970-01-01 08:00:00,"88a8a0670dfffff",120,206,326
"1954",1970-01-01 08:00:00,"88a8a0672bfffff",60,103,163
"1955",1970-01-01 08:00:00,"88a8a06731fffff",180,309,489
"1956",1970-01-01 08:00:00,"88a8a06735fffff",180,309,489
"1957",1970-01-01 08:00:00,"88a8a06739fffff",240,412,652
"1958",1970-01-01 08:00:00,"88a8a0674dfffff",233,458,691
"1959",1970-01-01 08:00:00,"88a8a0676bfffff",360,618,978
"1960",1970-01-01 08:00:00,"88a8a06a91fffff",206,599,805
"1961",1970-01-01 08:00:00,"88a8a06a9bfffff",208,598,806
"1962",1970-01-01 08:00:00,"88a8a06e49fffff",317,737,1054
"1963",1970-01-01 08:00:00,"88a8a06e4dfffff",419,1152,1571
"1964",1970-01-01 08:00:00,"88a8a06e69fffff",60,103,163
"1965",1970-01-01 08:00:00,"88a8a06e6dfffff",419,1152,1571
"1966",1970-01-01 08:00:00,"88a8a06f05fffff",102,300,402
"1967",1970-01-01 08:00:00,"88a8a06f59fffff",0,0,0
"1968",1970-01-01 08:00:00,"88a8a06f61fffff",51,150,201
"1969",1970-01-01 08:00:00,"88a8a06f63fffff",153,450,603
"1970",1970-01-01 08:00:00,"88a8a06f67fffff",51,150,201
"1971",1970-01-01 08:00:00,"88a8a06f69fffff",204,600,804
"1972",1970-01-01 08:00:00,"88a8a070b3fffff",735,1344,2079
"1973",1970-01-01 08:00:00,"88a8a070b7fffff",795,1447,2242
"1974",1970-01-01 08:00:00,"88a8a0719bfffff",384,679,1063
"1975",1970-01-01 08:00:00,"88a8a07441fffff",1220,2444,3664
"1976",1970-01-01 08:00:00,"88a8a07443fffff",51,150,201
"1977",1970-01-01 08:00:00,"88a8a07445fffff",560,1084,1644
"1978",1970-01-01 08:00:00,"88a8a07447fffff",732,1495,2227
"1979",1970-01-01 08:00:00,"88a8a0744bfffff",1175,2452,3627
"1980",1970-01-01 08:00:00,"88a8a07461fffff",1272,2559,3831
"1981",1970-01-01 08:00:00,"88a8a07465fffff",1169,2294,3463
"1982",1970-01-01 08:00:00,"88a8a07469fffff",195,532,727
"1983",1970-01-01 08:00:00,"88a8a0746bfffff",1331,2697,4028
"1984",1970-01-01 08:00:00,"88a8a07503fffff",60,103,163
"1985",1970-01-01 08:00:00,"88a8a07507fffff",738,1560,2298
"1986",1970-01-01 08:00:00,"88a8a07515fffff",566,1217,1783
"1987",1970-01-01 08:00:00,"88a8a0751bfffff",0,0,0
"1988",1970-01-01 08:00:00,"88a8a0751dfffff",51,150,201
"1989",1970-01-01 08:00:00,"88a8a07521fffff",1232,2667,3899
"1990",1970-01-01 08:00:00,"88a8a07525fffff",857,1941,2798
"1991",1970-01-01 08:00:00,"88a8a07529fffff",0,0,0
"1992",1970-01-01 08:00:00,"88a8a0752bfffff",1163,2496,3659
"1993",1970-01-01 08:00:00,"88a8a0752dfffff",1283,2817,4100
"1994",1970-01-01 08:00:00,"88a8a07531fffff",1320,2846,4166
"1995",1970-01-01 08:00:00,"88a8a07533fffff",293,561,854
"1996",1970-01-01 08:00:00,"88a8a07535fffff",858,1928,2786
"1997",1970-01-01 08:00:00,"88a8a07537fffff",293,561,854
"1998",1970-01-01 08:00:00,"88a8a07539fffff",1405,3022,4427
"1999",1970-01-01 08:00:00,"88a8a0753dfffff",471,1174,1645
"2000",1970-01-01 08:00:00,"88a8a07543fffff",841,1588,2429
"2001",1970-01-01 08:00:00,"88a8a07545fffff",447,807,1254
"2002",1970-01-01 08:00:00,"88a8a07547fffff",781,1485,2266
"2003",1970-01-01 08:00:00,"88a8a07553fffff",93,232,325
"2004",1970-01-01 08:00:00,"88a8a07557fffff",93,232,325
"2005",1970-01-01 08:00:00,"88a8a07559fffff",1051,2087,3138
"2006",1970-01-01 08:00:00,"88a8a0755bfffff",93,232,325
"2007",1970-01-01 08:00:00,"88a8a0755dfffff",943,1888,2831
"2008",1970-01-01 08:00:00,"88a8a07561fffff",1239,2621,3860
"2009",1970-01-01 08:00:00,"88a8a07565fffff",284,608,892
"2010",1970-01-01 08:00:00,"88a8a07567fffff",1181,2632,3813
"2011",1970-01-01 08:00:00,"88a8a07569fffff",820,1603,2423
"2012",1970-01-01 08:00:00,"88a8a0756bfffff",233,458,691
"2013",1970-01-01 08:00:00,"88a8a0756dfffff",1723,3555,5278
"2014",1970-01-01 08:00:00,"88a8a07633fffff",1217,2534,3751
"2015",1970-01-01 08:00:00,"88a8a07637fffff",1055,2246,3301
"2016",1970-01-01 08:00:00,"88a8a076c7fffff",393,862,1255
"2017",1970-01-01 08:00:00,"88a8a076cbfffff",0,0,0
"2018",1970-01-01 08:00:00,"88a8a076d1fffff",677,1355,2032
"2019",1970-01-01 08:00:00,"88a8a076d3fffff",1037,2200,3237
"2020",1970-01-01 08:00:00,"88a8a076d5fffff",776,1576,2352
"2021",1970-01-01 08:00:00,"88a8a076d7fffff",171,356,527
"2022",1970-01-01 08:00:00,"88a8a076e9fffff",612,1289,1901
"2023",1970-01-01 08:00:00,"88a8a076ebfffff",386,908,1294
"2024",1970-01-01 08:00:00,"88a8a076edfffff",836,1794,2630
"2025",1970-01-01 08:30:00,"88a8a02801fffff",81,131,212
"2026",1970-01-01 08:30:00,"88a8a02805fffff",33,60,93
"2027",1970-01-01 08:30:00,"88a8a02809fffff",0,0,0
"2028",1970-01-01 08:30:00,"88a8a0280bfffff",81,131,212
"2029",1970-01-01 08:30:00,"88a8a02825fffff",33,60,93
"2030",1970-01-01 08:30:00,"88a8a02829fffff",33,60,93
"2031",1970-01-01 08:30:00,"88a8a0282dfffff",33,60,93
"2032",1970-01-01 08:30:00,"88a8a02853fffff",137,359,496
"2033",1970-01-01 08:30:00,"88a8a02857fffff",33,60,93
"2034",1970-01-01 08:30:00,"88a8a02919fffff",33,60,93
"2035",1970-01-01 08:30:00,"88a8a02a01fffff",102,185,287
"2036",1970-01-01 08:30:00,"88a8a02a05fffff",219,427,646
"2037",1970-01-01 08:30:00,"88a8a02a0dfffff",60,103,163
"2038",1970-01-01 08:30:00,"88a8a02a11fffff",102,300,402
"2039",1970-01-01 08:30:00,"88a8a02a13fffff",102,300,402
"2040",1970-01-01 08:30:00,"88a8a02a19fffff",102,300,402
"2041",1970-01-01 08:30:00,"88a8a02a57fffff",153,450,603
"2042",1970-01-01 08:30:00,"88a8a02a61fffff",215,437,652
"2043",1970-01-01 08:30:00,"88a8a02a63fffff",314,658,972
"2044",1970-01-01 08:30:00,"88a8a02a69fffff",155,334,489
"2045",1970-01-01 08:30:00,"88a8a02a6bfffff",0,0,0
"2046",1970-01-01 08:30:00,"88a8a02a89fffff",168,420,588
"2047",1970-01-01 08:30:00,"88a8a02a8bfffff",168,420,588
"2048",1970-01-01 08:30:00,"88a8a02a9dfffff",168,420,588
"2049",1970-01-01 08:30:00,"88a8a02aadfffff",170,419,589
"2050",1970-01-01 08:30:00,"88a8a02ac5fffff",203,520,723
"2051",1970-01-01 08:30:00,"88a8a02ac7fffff",272,719,991
"2052",1970-01-01 08:30:00,"88a8a02ae3fffff",170,419,589
"2053",1970-01-01 08:30:00,"88a8a02ae7fffff",170,419,589
"2054",1970-01-01 08:30:00,"88a8a02aebfffff",170,419,589
"2055",1970-01-01 08:30:00,"88a8a03987fffff",363,694,1057
"2056",1970-01-01 08:30:00,"88a8a03995fffff",381,715,1096
"2057",1970-01-01 08:30:00,"88a8a03997fffff",300,512,812
"2058",1970-01-01 08:30:00,"88a8a039a1fffff",705,1406,2111
"2059",1970-01-01 08:30:00,"88a8a039abfffff",824,1647,2471
"2060",1970-01-01 08:30:00,"88a8a039adfffff",762,1430,2192
"2061",1970-01-01 08:30:00,"88a8a039b9fffff",704,1441,2145
"2062",1970-01-01 08:30:00,"88a8a039bbfffff",593,1188,1781
"2063",1970-01-01 08:30:00,"88a8a039bdfffff",224,505,729
"2064",1970-01-01 08:30:00,"88a8a06085fffff",612,1570,2182
"2065",1970-01-01 08:30:00,"88a8a0608dfffff",854,2028,2882
"2066",1970-01-01 08:30:00,"88a8a060a3fffff",315,853,1168
"2067",1970-01-01 08:30:00,"88a8a060a7fffff",51,150,201
"2068",1970-01-01 08:30:00,"88a8a060abfffff",264,703,967
"2069",1970-01-01 08:30:00,"88a8a060c1fffff",159,349,508
"2070",1970-01-01 08:30:00,"88a8a060c3fffff",564,1265,1829
"2071",1970-01-01 08:30:00,"88a8a060c7fffff",507,1216,1723
"2072",1970-01-01 08:30:00,"88a8a060cbfffff",726,1668,2394
"2073",1970-01-01 08:30:00,"88a8a06193fffff",359,934,1293
"2074",1970-01-01 08:30:00,"88a8a06197fffff",264,703,967
"2075",1970-01-01 08:30:00,"88a8a0619bfffff",102,300,402
"2076",1970-01-01 08:30:00,"88a8a061a1fffff",197,531,728
"2077",1970-01-01 08:30:00,"88a8a061a3fffff",155,449,604
"2078",1970-01-01 08:30:00,"88a8a061a5fffff",153,450,603
"2079",1970-01-01 08:30:00,"88a8a061b1fffff",275,655,930
"2080",1970-01-01 08:30:00,"88a8a061b3fffff",257,634,891
"2081",1970-01-01 08:30:00,"88a8a061b5fffff",206,599,805
"2082",1970-01-01 08:30:00,"88a8a061b7fffff",257,749,1006
"2083",1970-01-01 08:30:00,"88a8a06249fffff",819,1623,2442
"2084",1970-01-01 08:30:00,"88a8a0624bfffff",708,1370,2078
"2085",1970-01-01 08:30:00,"88a8a0624dfffff",750,1452,2202
"2086",1970-01-01 08:30:00,"88a8a06281fffff",464,1079,1543
"2087",1970-01-01 08:30:00,"88a8a06283fffff",869,1995,2864
"2088",1970-01-01 08:30:00,"88a8a06287fffff",719,1599,2318
"2089",1970-01-01 08:30:00,"88a8a06289fffff",986,2262,3248
"2090",1970-01-01 08:30:00,"88a8a0628bfffff",573,1218,1791
"2091",1970-01-01 08:30:00,"88a8a06293fffff",171,356,527
"2092",1970-01-01 08:30:00,"88a8a06299fffff",111,253,364
"2093",1970-01-01 08:30:00,"88a8a0629bfffff",351,665,1016
"2094",1970-01-01 08:30:00,"88a8a062b5fffff",737,1735,2472
"2095",1970-01-01 08:30:00,"88a8a062bdfffff",839,1920,2759
"2096",1970-01-01 08:30:00,"88a8a062c1fffff",455,1011,1466
"2097",1970-01-01 08:30:00,"88a8a062c3fffff",725,1613,2338
"2098",1970-01-01 08:30:00,"88a8a062cbfffff",773,1803,2576
"2099",1970-01-01 08:30:00,"88a8a062d1fffff",411,768,1179
"2100",1970-01-01 08:30:00,"88a8a062d3fffff",300,515,815
"2101",1970-01-01 08:30:00,"88a8a062d9fffff",524,1020,1544
"2102",1970-01-01 08:30:00,"88a8a06541fffff",60,103,163
"2103",1970-01-01 08:30:00,"88a8a06549fffff",60,103,163
"2104",1970-01-01 08:30:00,"88a8a06705fffff",404,814,1218
"2105",1970-01-01 08:30:00,"88a8a06707fffff",180,309,489
"2106",1970-01-01 08:30:00,"88a8a0670dfffff",60,103,163
"2107",1970-01-01 08:30:00,"88a8a0672bfffff",111,253,364
"2108",1970-01-01 08:30:00,"88a8a06731fffff",120,206,326
"2109",1970-01-01 08:30:00,"88a8a06735fffff",240,412,652
"2110",1970-01-01 08:30:00,"88a8a06739fffff",180,309,489
"2111",1970-01-01 08:30:00,"88a8a0673dfffff",60,103,163
"2112",1970-01-01 08:30:00,"88a8a0674dfffff",171,356,527
"2113",1970-01-01 08:30:00,"88a8a0676bfffff",233,458,691
"2114",1970-01-01 08:30:00,"88a8a06a91fffff",153,450,603
"2115",1970-01-01 08:30:00,"88a8a06a9bfffff",153,450,603
"2116",1970-01-01 08:30:00,"88a8a06e49fffff",366,1003,1369
"2117",1970-01-01 08:30:00,"88a8a06e4dfffff",315,853,1168
"2118",1970-01-01 08:30:00,"88a8a06e69fffff",113,252,365
"2119",1970-01-01 08:30:00,"88a8a06e6dfffff",368,887,1255
"2120",1970-01-01 08:30:00,"88a8a06f05fffff",51,150,201
"2121",1970-01-01 08:30:00,"88a8a06f61fffff",51,150,201
"2122",1970-01-01 08:30:00,"88a8a06f63fffff",153,450,603
"2123",1970-01-01 08:30:00,"88a8a06f69fffff",102,300,402
"2124",1970-01-01 08:30:00,"88a8a070b3fffff",888,1679,2567
"2125",1970-01-01 08:30:00,"88a8a070b7fffff",948,1782,2730
"2126",1970-01-01 08:30:00,"88a8a0719bfffff",435,829,1264
"2127",1970-01-01 08:30:00,"88a8a07441fffff",1250,2494,3744
"2128",1970-01-01 08:30:00,"88a8a07445fffff",551,1106,1657
"2129",1970-01-01 08:30:00,"88a8a07447fffff",1037,2056,3093
"2130",1970-01-01 08:30:00,"88a8a0744bfffff",977,1953,2930
"2131",1970-01-01 08:30:00,"88a8a07461fffff",1291,2636,3927
"2132",1970-01-01 08:30:00,"88a8a07465fffff",1140,2444,3584
"2133",1970-01-01 08:30:00,"88a8a07467fffff",99,246,345
"2134",1970-01-01 08:30:00,"88a8a07469fffff",96,192,288
"2135",1970-01-01 08:30:00,"88a8a0746bfffff",1180,2383,3563
"2136",1970-01-01 08:30:00,"88a8a07503fffff",173,355,528
"2137",1970-01-01 08:30:00,"88a8a07507fffff",764,1594,2358
"2138",1970-01-01 08:30:00,"88a8a07515fffff",743,1472,2215
"2139",1970-01-01 08:30:00,"88a8a0751dfffff",159,349,508
"2140",1970-01-01 08:30:00,"88a8a07521fffff",1201,2422,3623
"2141",1970-01-01 08:30:00,"88a8a07525fffff",356,765,1121
"2142",1970-01-01 08:30:00,"88a8a0752bfffff",1270,2593,3863
"2143",1970-01-01 08:30:00,"88a8a0752dfffff",1081,2216,3297
"2144",1970-01-01 08:30:00,"88a8a07531fffff",1699,3429,5128
"2145",1970-01-01 08:30:00,"88a8a07533fffff",231,459,690
"2146",1970-01-01 08:30:00,"88a8a07535fffff",827,1913,2740
"2147",1970-01-01 08:30:00,"88a8a07537fffff",464,917,1381
"2148",1970-01-01 08:30:00,"88a8a07539fffff",1300,2621,3921
"2149",1970-01-01 08:30:00,"88a8a0753bfffff",180,309,489
"2150",1970-01-01 08:30:00,"88a8a0753dfffff",681,1417,2098
"2151",1970-01-01 08:30:00,"88a8a07543fffff",1073,2152,3225
"2152",1970-01-01 08:30:00,"88a8a07545fffff",558,1085,1643
"2153",1970-01-01 08:30:00,"88a8a07547fffff",1133,2255,3388
"2154",1970-01-01 08:30:00,"88a8a07553fffff",111,253,364
"2155",1970-01-01 08:30:00,"88a8a07557fffff",99,246,345
"2156",1970-01-01 08:30:00,"88a8a07559fffff",1004,2071,3075
"2157",1970-01-01 08:30:00,"88a8a0755bfffff",159,349,508
"2158",1970-01-01 08:30:00,"88a8a0755dfffff",1071,2153,3224
"2159",1970-01-01 08:30:00,"88a8a07561fffff",938,1889,2827
"2160",1970-01-01 08:30:00,"88a8a07565fffff",60,103,163
"2161",1970-01-01 08:30:00,"88a8a07567fffff",1088,2170,3258
"2162",1970-01-01 08:30:00,"88a8a07569fffff",1073,2152,3225
"2163",1970-01-01 08:30:00,"88a8a0756bfffff",632,1219,1851
"2164",1970-01-01 08:30:00,"88a8a0756dfffff",2008,3991,5999
"2165",1970-01-01 08:30:00,"88a8a07633fffff",929,1882,2811
"2166",1970-01-01 08:30:00,"88a8a07637fffff",989,1985,2974
"2167",1970-01-01 08:30:00,"88a8a076c7fffff",269,497,766
"2168",1970-01-01 08:30:00,"88a8a076d1fffff",477,882,1359
"2169",1970-01-01 08:30:00,"88a8a076d3fffff",693,1399,2092
"2170",1970-01-01 08:30:00,"88a8a076d5fffff",483,1040,1523
"2171",1970-01-01 08:30:00,"88a8a076d7fffff",210,474,684
"2172",1970-01-01 08:30:00,"88a8a076e9fffff",518,999,1517
"2173",1970-01-01 08:30:00,"88a8a076ebfffff",302,626,928
"2174",1970-01-01 08:30:00,"88a8a076edfffff",689,1355,2044
"2175",1970-01-01 09:00:00,"88a8a02801fffff",101,220,321
"2176",1970-01-01 09:00:00,"88a8a02809fffff",101,220,321
"2177",1970-01-01 09:00:00,"88a8a0280bfffff",101,220,321
"2178",1970-01-01 09:00:00,"88a8a02853fffff",81,131,212
"2179",1970-01-01 09:00:00,"88a8a02857fffff",134,280,414
"2180",1970-01-01 09:00:00,"88a8a02a01fffff",347,733,1080
"2181",1970-01-01 09:00:00,"88a8a02a05fffff",506,1057,1563
"2182",1970-01-01 09:00:00,"88a8a02a0bfffff",99,221,320
"2183",1970-01-01 09:00:00,"88a8a02a11fffff",150,371,521
"2184",1970-01-01 09:00:00,"88a8a02a13fffff",150,371,521
"2185",1970-01-01 09:00:00,"88a8a02a19fffff",150,371,521
"2186",1970-01-01 09:00:00,"88a8a02a57fffff",99,221,320
"2187",1970-01-01 09:00:00,"88a8a02a61fffff",308,615,923
"2188",1970-01-01 09:00:00,"88a8a02a63fffff",458,986,1444
"2189",1970-01-01 09:00:00,"88a8a02a69fffff",506,1057,1563
"2190",1970-01-01 09:00:00,"88a8a02a6bfffff",51,150,201
"2191",1970-01-01 09:00:00,"88a8a02a6dfffff",99,221,320
"2192",1970-01-01 09:00:00,"88a8a02a89fffff",246,613,859
"2193",1970-01-01 09:00:00,"88a8a02a8bfffff",246,613,859
"2194",1970-01-01 09:00:00,"88a8a02a9dfffff",164,402,566
"2195",1970-01-01 09:00:00,"88a8a02aa9fffff",33,60,93
"2196",1970-01-01 09:00:00,"88a8a02aadfffff",81,131,212
"2197",1970-01-01 09:00:00,"88a8a02ac5fffff",201,521,722
"2198",1970-01-01 09:00:00,"88a8a02ac7fffff",294,684,978
"2199",1970-01-01 09:00:00,"88a8a02ae3fffff",81,131,212
"2200",1970-01-01 09:00:00,"88a8a02ae7fffff",48,71,119
"2201",1970-01-01 09:00:00,"88a8a02aebfffff",81,131,212
"2202",1970-01-01 09:00:00,"88a8a03987fffff",231,459,690
"2203",1970-01-01 09:00:00,"88a8a03995fffff",494,1082,1576
"2204",1970-01-01 09:00:00,"88a8a03997fffff",422,947,1369
"2205",1970-01-01 09:00:00,"88a8a039a1fffff",701,1387,2088
"2206",1970-01-01 09:00:00,"88a8a039abfffff",662,1359,2021
"2207",1970-01-01 09:00:00,"88a8a039adfffff",761,1490,2251
"2208",1970-01-01 09:00:00,"88a8a039b9fffff",662,1359,2021
"2209",1970-01-01 09:00:00,"88a8a039bbfffff",542,1153,1695
"2210",1970-01-01 09:00:00,"88a8a039bdfffff",104,299,403
"2211",1970-01-01 09:00:00,"88a8a06081fffff",60,103,163
"2212",1970-01-01 09:00:00,"88a8a06085fffff",856,2142,2998
"2213",1970-01-01 09:00:00,"88a8a0608dfffff",997,2329,3326
"2214",1970-01-01 09:00:00,"88a8a060a3fffff",350,981,1331
"2215",1970-01-01 09:00:00,"88a8a060a7fffff",102,300,402
"2216",1970-01-01 09:00:00,"88a8a060abfffff",359,934,1293
"2217",1970-01-01 09:00:00,"88a8a060c1fffff",84,164,248
"2218",1970-01-01 09:00:00,"88a8a060c3fffff",675,1518,2193
"2219",1970-01-01 09:00:00,"88a8a060c7fffff",681,1532,2213
"2220",1970-01-01 09:00:00,"88a8a060cbfffff",555,1312,1867
"2221",1970-01-01 09:00:00,"88a8a06193fffff",297,832,1129
"2222",1970-01-01 09:00:00,"88a8a06197fffff",195,532,727
"2223",1970-01-01 09:00:00,"88a8a0619bfffff",51,150,201
"2224",1970-01-01 09:00:00,"88a8a061a1fffff",195,532,727
"2225",1970-01-01 09:00:00,"88a8a061a3fffff",195,532,727
"2226",1970-01-01 09:00:00,"88a8a061a5fffff",102,300,402
"2227",1970-01-01 09:00:00,"88a8a061b1fffff",348,982,1330
"2228",1970-01-01 09:00:00,"88a8a061b3fffff",348,982,1330
"2229",1970-01-01 09:00:00,"88a8a061b5fffff",246,682,928
"2230",1970-01-01 09:00:00,"88a8a061b7fffff",390,1064,1454
"2231",1970-01-01 09:00:00,"88a8a06249fffff",933,1674,2607
"2232",1970-01-01 09:00:00,"88a8a0624bfffff",993,1777,2770
"2233",1970-01-01 09:00:00,"88a8a0624dfffff",984,1824,2808
"2234",1970-01-01 09:00:00,"88a8a06281fffff",288,649,937
"2235",1970-01-01 09:00:00,"88a8a06283fffff",570,1258,1828
"2236",1970-01-01 09:00:00,"88a8a06287fffff",417,923,1340
"2237",1970-01-01 09:00:00,"88a8a06289fffff",459,1005,1464
"2238",1970-01-01 09:00:00,"88a8a0628bfffff",357,820,1177
"2239",1970-01-01 09:00:00,"88a8a06293fffff",293,561,854
"2240",1970-01-01 09:00:00,"88a8a06299fffff",120,206,326
"2241",1970-01-01 09:00:00,"88a8a0629bfffff",173,355,528
"2242",1970-01-01 09:00:00,"88a8a062b5fffff",555,1312,1867
"2243",1970-01-01 09:00:00,"88a8a062bdfffff",456,1066,1522
"2244",1970-01-01 09:00:00,"88a8a062c1fffff",144,267,411
"2245",1970-01-01 09:00:00,"88a8a062c3fffff",507,1101,1608
"2246",1970-01-01 09:00:00,"88a8a062cbfffff",474,972,1446
"2247",1970-01-01 09:00:00,"88a8a062d1fffff",293,561,854
"2248",1970-01-01 09:00:00,"88a8a062d3fffff",293,561,854
"2249",1970-01-01 09:00:00,"88a8a062d9fffff",293,561,854
"2250",1970-01-01 09:00:00,"88a8a06541fffff",231,459,690
"2251",1970-01-01 09:00:00,"88a8a06549fffff",351,665,1016
"2252",1970-01-01 09:00:00,"88a8a06705fffff",180,309,489
"2253",1970-01-01 09:00:00,"88a8a0670dfffff",60,103,163
"2254",1970-01-01 09:00:00,"88a8a0672bfffff",60,103,163
"2255",1970-01-01 09:00:00,"88a8a06731fffff",60,103,163
"2256",1970-01-01 09:00:00,"88a8a06735fffff",342,712,1054
"2257",1970-01-01 09:00:00,"88a8a06739fffff",60,103,163
"2258",1970-01-01 09:00:00,"88a8a0674dfffff",240,412,652
"2259",1970-01-01 09:00:00,"88a8a0676bfffff",180,309,489
"2260",1970-01-01 09:00:00,"88a8a06a91fffff",102,300,402
"2261",1970-01-01 09:00:00,"88a8a06a9bfffff",51,150,201
"2262",1970-01-01 09:00:00,"88a8a06e49fffff",290,763,1053
"2263",1970-01-01 09:00:00,"88a8a06e4dfffff",341,913,1254
"2264",1970-01-01 09:00:00,"88a8a06e69fffff",102,300,402
"2265",1970-01-01 09:00:00,"88a8a06e6dfffff",348,982,1330
"2266",1970-01-01 09:00:00,"88a8a06f69fffff",51,150,201
"2267",1970-01-01 09:00:00,"88a8a070b3fffff",873,1571,2444
"2268",1970-01-01 09:00:00,"88a8a070b7fffff",753,1365,2118
"2269",1970-01-01 09:00:00,"88a8a0719bfffff",693,1262,1955
"2270",1970-01-01 09:00:00,"88a8a07441fffff",946,1992,2938
"2271",1970-01-01 09:00:00,"88a8a07443fffff",51,150,201
"2272",1970-01-01 09:00:00,"88a8a07445fffff",621,1267,1888
"2273",1970-01-01 09:00:00,"88a8a07447fffff",565,1162,1727
"2274",1970-01-01 09:00:00,"88a8a0744bfffff",907,1874,2781
"2275",1970-01-01 09:00:00,"88a8a07461fffff",1162,2509,3671
"2276",1970-01-01 09:00:00,"88a8a07465fffff",968,2032,3000
"2277",1970-01-01 09:00:00,"88a8a07467fffff",90,178,268
"2278",1970-01-01 09:00:00,"88a8a07469fffff",246,567,813
"2279",1970-01-01 09:00:00,"88a8a0746bfffff",1111,2359,3470
"2280",1970-01-01 09:00:00,"88a8a07503fffff",173,355,528
"2281",1970-01-01 09:00:00,"88a8a07507fffff",869,1833,2702
"2282",1970-01-01 09:00:00,"88a8a07515fffff",554,1095,1649
"2283",1970-01-01 09:00:00,"88a8a0751dfffff",153,335,488
"2284",1970-01-01 09:00:00,"88a8a07521fffff",980,1971,2951
"2285",1970-01-01 09:00:00,"88a8a07525fffff",605,1130,1735
"2286",1970-01-01 09:00:00,"88a8a0752bfffff",938,1889,2827
"2287",1970-01-01 09:00:00,"88a8a0752dfffff",911,1915,2826
"2288",1970-01-01 09:00:00,"88a8a07531fffff",1367,2725,4092
"2289",1970-01-01 09:00:00,"88a8a07533fffff",173,355,528
"2290",1970-01-01 09:00:00,"88a8a07535fffff",615,1300,1915
"2291",1970-01-01 09:00:00,"88a8a07537fffff",180,309,489
"2292",1970-01-01 09:00:00,"88a8a07539fffff",996,1993,2989
"2293",1970-01-01 09:00:00,"88a8a0753bfffff",162,288,450
"2294",1970-01-01 09:00:00,"88a8a0753dfffff",384,794,1178
"2295",1970-01-01 09:00:00,"88a8a07543fffff",686,1423,2109
"2296",1970-01-01 09:00:00,"88a8a07545fffff",573,1056,1629
"2297",1970-01-01 09:00:00,"88a8a07547fffff",659,1449,2108
"2298",1970-01-01 09:00:00,"88a8a07553fffff",201,431,632
"2299",1970-01-01 09:00:00,"88a8a07557fffff",159,349,508
"2300",1970-01-01 09:00:00,"88a8a07559fffff",950,2011,2961
"2301",1970-01-01 09:00:00,"88a8a0755bfffff",201,431,632
"2302",1970-01-01 09:00:00,"88a8a0755dfffff",737,1573,2310
"2303",1970-01-01 09:00:00,"88a8a07561fffff",770,1587,2357
"2304",1970-01-01 09:00:00,"88a8a07565fffff",297,717,1014
"2305",1970-01-01 09:00:00,"88a8a07567fffff",1144,2373,3517
"2306",1970-01-01 09:00:00,"88a8a07569fffff",788,1723,2511
"2307",1970-01-01 09:00:00,"88a8a0756bfffff",555,1150,1705
"2308",1970-01-01 09:00:00,"88a8a0756dfffff",1682,3416,5098
"2309",1970-01-01 09:00:00,"88a8a07633fffff",839,1614,2453
"2310",1970-01-01 09:00:00,"88a8a07637fffff",782,1590,2372
"2311",1970-01-01 09:00:00,"88a8a076c7fffff",431,925,1356
"2312",1970-01-01 09:00:00,"88a8a076d1fffff",554,1185,1739
"2313",1970-01-01 09:00:00,"88a8a076d3fffff",824,1672,2496
"2314",1970-01-01 09:00:00,"88a8a076d5fffff",663,1349,2012
"2315",1970-01-01 09:00:00,"88a8a076d7fffff",276,476,752
"2316",1970-01-01 09:00:00,"88a8a076e9fffff",611,1234,1845
"2317",1970-01-01 09:00:00,"88a8a076ebfffff",500,981,1481
"2318",1970-01-01 09:00:00,"88a8a076edfffff",770,1558,2328
"2319",1970-01-01 09:30:00,"88a8a02801fffff",66,120,186
"2320",1970-01-01 09:30:00,"88a8a02805fffff",66,120,186
"2321",1970-01-01 09:30:00,"88a8a02809fffff",48,71,119
"2322",1970-01-01 09:30:00,"88a8a02825fffff",33,60,93
"2323",1970-01-01 09:30:00,"88a8a02829fffff",66,120,186
"2324",1970-01-01 09:30:00,"88a8a0282dfffff",66,120,186
"2325",1970-01-01 09:30:00,"88a8a02857fffff",51,150,201
"2326",1970-01-01 09:30:00,"88a8a02919fffff",33,60,93
"2327",1970-01-01 09:30:00,"88a8a0291dfffff",33,60,93
"2328",1970-01-01 09:30:00,"88a8a02953fffff",33,60,93
"2329",1970-01-01 09:30:00,"88a8a02957fffff",66,120,186
"2330",1970-01-01 09:30:00,"88a8a02a01fffff",424,971,1395
"2331",1970-01-01 09:30:00,"88a8a02a05fffff",376,900,1276
"2332",1970-01-01 09:30:00,"88a8a02a0bfffff",60,103,163
"2333",1970-01-01 09:30:00,"88a8a02a0dfffff",48,71,119
"2334",1970-01-01 09:30:00,"88a8a02a11fffff",164,402,566
"2335",1970-01-01 09:30:00,"88a8a02a13fffff",157,448,605
"2336",1970-01-01 09:30:00,"88a8a02a19fffff",212,473,685
"2337",1970-01-01 09:30:00,"88a8a02a57fffff",308,615,923
"2338",1970-01-01 09:30:00,"88a8a02a61fffff",164,402,566
"2339",1970-01-01 09:30:00,"88a8a02a63fffff",374,901,1275
"2340",1970-01-01 09:30:00,"88a8a02a69fffff",374,876,1250
"2341",1970-01-01 09:30:00,"88a8a02a6bfffff",102,300,402
"2342",1970-01-01 09:30:00,"88a8a02a89fffff",301,761,1062
"2343",1970-01-01 09:30:00,"88a8a02a8bfffff",301,761,1062
"2344",1970-01-01 09:30:00,"88a8a02a9dfffff",215,552,767
"2345",1970-01-01 09:30:00,"88a8a02aadfffff",84,210,294
"2346",1970-01-01 09:30:00,"88a8a02ac5fffff",217,551,768
"2347",1970-01-01 09:30:00,"88a8a02ac7fffff",352,911,1263
"2348",1970-01-01 09:30:00,"88a8a02ae3fffff",132,306,438
"2349",1970-01-01 09:30:00,"88a8a02ae7fffff",84,210,294
"2350",1970-01-01 09:30:00,"88a8a02aebfffff",132,306,438
"2351",1970-01-01 09:30:00,"88a8a03987fffff",228,380,608
"2352",1970-01-01 09:30:00,"88a8a03995fffff",213,553,766
"2353",1970-01-01 09:30:00,"88a8a03997fffff",410,940,1350
"2354",1970-01-01 09:30:00,"88a8a039a1fffff",662,1359,2021
"2355",1970-01-01 09:30:00,"88a8a039abfffff",761,1605,2366
"2356",1970-01-01 09:30:00,"88a8a039adfffff",674,1391,2065
"2357",1970-01-01 09:30:00,"88a8a039b9fffff",920,1929,2849
"2358",1970-01-01 09:30:00,"88a8a039bbfffff",722,1487,2209
"2359",1970-01-01 09:30:00,"88a8a039bdfffff",210,499,709
"2360",1970-01-01 09:30:00,"88a8a06031fffff",0,0,0
"2361",1970-01-01 09:30:00,"88a8a06037fffff",0,0,0
"2362",1970-01-01 09:30:00,"88a8a06039fffff",0,0,0
"2363",1970-01-01 09:30:00,"88a8a06053fffff",0,0,0
"2364",1970-01-01 09:30:00,"88a8a06081fffff",53,149,202
"2365",1970-01-01 09:30:00,"88a8a06085fffff",480,1127,1607
"2366",1970-01-01 09:30:00,"88a8a0608dfffff",871,2020,2891
"2367",1970-01-01 09:30:00,"88a8a060a3fffff",153,450,603
"2368",1970-01-01 09:30:00,"88a8a060abfffff",153,450,603
"2369",1970-01-01 09:30:00,"88a8a060c3fffff",539,1175,1714
"2370",1970-01-01 09:30:00,"88a8a060c7fffff",479,1072,1551
"2371",1970-01-01 09:30:00,"88a8a060cbfffff",599,1278,1877
"2372",1970-01-01 09:30:00,"88a8a0618dfffff",0,0,0
"2373",1970-01-01 09:30:00,"88a8a06193fffff",255,750,1005
"2374",1970-01-01 09:30:00,"88a8a06197fffff",102,300,402
"2375",1970-01-01 09:30:00,"88a8a0619bfffff",51,150,201
"2376",1970-01-01 09:30:00,"88a8a061a1fffff",201,534,735
"2377",1970-01-01 09:30:00,"88a8a061a3fffff",201,534,735
"2378",1970-01-01 09:30:00,"88a8a061a5fffff",276,630,906
"2379",1970-01-01 09:30:00,"88a8a061b1fffff",153,450,603
"2380",1970-01-01 09:30:00,"88a8a061b3fffff",255,750,1005
"2381",1970-01-01 09:30:00,"88a8a061b5fffff",255,750,1005
"2382",1970-01-01 09:30:00,"88a8a061b7fffff",255,750,1005
"2383",1970-01-01 09:30:00,"88a8a061c3fffff",0,0,0
"2384",1970-01-01 09:30:00,"88a8a061c7fffff",0,0,0
"2385",1970-01-01 09:30:00,"88a8a061cbfffff",0,0,0
"2386",1970-01-01 09:30:00,"88a8a06213fffff",0,0,0
"2387",1970-01-01 09:30:00,"88a8a0621bfffff",0,0,0
"2388",1970-01-01 09:30:00,"88a8a06249fffff",933,1674,2607
"2389",1970-01-01 09:30:00,"88a8a0624bfffff",1104,2030,3134
"2390",1970-01-01 09:30:00,"88a8a0624dfffff",1164,2133,3297
"2391",1970-01-01 09:30:00,"88a8a06281fffff",372,787,1159
"2392",1970-01-01 09:30:00,"88a8a06283fffff",809,1777,2586
"2393",1970-01-01 09:30:00,"88a8a06287fffff",590,1325,1915
"2394",1970-01-01 09:30:00,"88a8a06289fffff",677,1517,2194
"2395",1970-01-01 09:30:00,"88a8a0628bfffff",353,826,1179
"2396",1970-01-01 09:30:00,"88a8a06293fffff",164,402,566
"2397",1970-01-01 09:30:00,"88a8a06299fffff",171,356,527
"2398",1970-01-01 09:30:00,"88a8a0629bfffff",231,459,690
"2399",1970-01-01 09:30:00,"88a8a062adfffff",0,0,0
"2400",1970-01-01 09:30:00,"88a8a062b5fffff",539,1175,1714
"2401",1970-01-01 09:30:00,"88a8a062bdfffff",638,1421,2059
"2402",1970-01-01 09:30:00,"88a8a062c1fffff",168,302,470
"2403",1970-01-01 09:30:00,"88a8a062c3fffff",686,1470,2156
"2404",1970-01-01 09:30:00,"88a8a062c5fffff",0,0,0
"2405",1970-01-01 09:30:00,"88a8a062cbfffff",524,1182,1706
"2406",1970-01-01 09:30:00,"88a8a062d1fffff",171,356,527
"2407",1970-01-01 09:30:00,"88a8a062d3fffff",171,356,527
"2408",1970-01-01 09:30:00,"88a8a062d9fffff",231,459,690
"2409",1970-01-01 09:30:00,"88a8a062dbfffff",51,150,201
"2410",1970-01-01 09:30:00,"88a8a062e7fffff",0,0,0
"2411",1970-01-01 09:30:00,"88a8a06541fffff",60,103,163
"2412",1970-01-01 09:30:00,"88a8a06549fffff",120,206,326
"2413",1970-01-01 09:30:00,"88a8a06705fffff",275,655,930
"2414",1970-01-01 09:30:00,"88a8a06707fffff",111,253,364
"2415",1970-01-01 09:30:00,"88a8a0670dfffff",53,149,202
"2416",1970-01-01 09:30:00,"88a8a0672bfffff",120,206,326
"2417",1970-01-01 09:30:00,"88a8a06731fffff",240,412,652
"2418",1970-01-01 09:30:00,"88a8a06735fffff",180,309,489
"2419",1970-01-01 09:30:00,"88a8a06739fffff",231,459,690
"2420",1970-01-01 09:30:00,"88a8a0673dfffff",60,103,163
"2421",1970-01-01 09:30:00,"88a8a0674dfffff",224,505,729
"2422",1970-01-01 09:30:00,"88a8a0676bfffff",284,608,892
"2423",1970-01-01 09:30:00,"88a8a06a91fffff",90,166,256
"2424",1970-01-01 09:30:00,"88a8a06a9bfffff",141,316,457
"2425",1970-01-01 09:30:00,"88a8a06ad3fffff",0,0,0
"2426",1970-01-01 09:30:00,"88a8a06adbfffff",0,0,0
"2427",1970-01-01 09:30:00,"88a8a06e49fffff",153,450,603
"2428",1970-01-01 09:30:00,"88a8a06e4dfffff",204,600,804
"2429",1970-01-01 09:30:00,"88a8a06e69fffff",51,150,201
"2430",1970-01-01 09:30:00,"88a8a06e6dfffff",102,300,402
"2431",1970-01-01 09:30:00,"88a8a06f05fffff",102,300,402
"2432",1970-01-01 09:30:00,"88a8a06f61fffff",102,300,402
"2433",1970-01-01 09:30:00,"88a8a06f63fffff",102,300,402
"2434",1970-01-01 09:30:00,"88a8a06f67fffff",102,300,402
"2435",1970-01-01 09:30:00,"88a8a06f69fffff",102,300,402
"2436",1970-01-01 09:30:00,"88a8a070b3fffff",993,1892,2885
"2437",1970-01-01 09:30:00,"88a8a070b7fffff",1104,2030,3134
"2438",1970-01-01 09:30:00,"88a8a0719bfffff",531,974,1505
"2439",1970-01-01 09:30:00,"88a8a07441fffff",495,1162,1657
"2440",1970-01-01 09:30:00,"88a8a07445fffff",222,506,728
"2441",1970-01-01 09:30:00,"88a8a07447fffff",273,656,929
"2442",1970-01-01 09:30:00,"88a8a0744bfffff",435,1059,1494
"2443",1970-01-01 09:30:00,"88a8a07461fffff",723,1593,2316
"2444",1970-01-01 09:30:00,"88a8a07465fffff",486,1094,1580
"2445",1970-01-01 09:30:00,"88a8a07467fffff",195,417,612
"2446",1970-01-01 09:30:00,"88a8a07469fffff",195,417,612
"2447",1970-01-01 09:30:00,"88a8a0746bfffff",597,1347,1944
"2448",1970-01-01 09:30:00,"88a8a07503fffff",60,103,163
"2449",1970-01-01 09:30:00,"88a8a07507fffff",813,1583,2396
"2450",1970-01-01 09:30:00,"88a8a07509fffff",0,0,0
"2451",1970-01-01 09:30:00,"88a8a07515fffff",606,1185,1791
"2452",1970-01-01 09:30:00,"88a8a0751dfffff",246,567,813
"2453",1970-01-01 09:30:00,"88a8a07521fffff",753,1480,2233
"2454",1970-01-01 09:30:00,"88a8a07525fffff",573,1171,1744
"2455",1970-01-01 09:30:00,"88a8a0752bfffff",993,1892,2885
"2456",1970-01-01 09:30:00,"88a8a0752dfffff",702,1330,2032
"2457",1970-01-01 09:30:00,"88a8a07531fffff",1133,2306,3439
"2458",1970-01-01 09:30:00,"88a8a07533fffff",282,609,891
"2459",1970-01-01 09:30:00,"88a8a07535fffff",545,1142,1687
"2460",1970-01-01 09:30:00,"88a8a07537fffff",222,506,728
"2461",1970-01-01 09:30:00,"88a8a07539fffff",1083,2070,3153
"2462",1970-01-01 09:30:00,"88a8a0753bfffff",213,438,651
"2463",1970-01-01 09:30:00,"88a8a0753dfffff",393,862,1255
"2464",1970-01-01 09:30:00,"88a8a07543fffff",564,1218,1782
"2465",1970-01-01 09:30:00,"88a8a07545fffff",213,438,651
"2466",1970-01-01 09:30:00,"88a8a07547fffff",444,897,1341
"2467",1970-01-01 09:30:00,"88a8a07553fffff",195,417,612
"2468",1970-01-01 09:30:00,"88a8a07557fffff",195,417,612
"2469",1970-01-01 09:30:00,"88a8a07559fffff",546,1197,1743
"2470",1970-01-01 09:30:00,"88a8a0755bfffff",204,485,689
"2471",1970-01-01 09:30:00,"88a8a0755dfffff",657,1450,2107
"2472",1970-01-01 09:30:00,"88a8a07561fffff",828,1435,2263
"2473",1970-01-01 09:30:00,"88a8a07565fffff",180,309,489
"2474",1970-01-01 09:30:00,"88a8a07567fffff",753,1365,2118
"2475",1970-01-01 09:30:00,"88a8a07569fffff",444,897,1341
"2476",1970-01-01 09:30:00,"88a8a0756bfffff",471,871,1342
"2477",1970-01-01 09:30:00,"88a8a0756dfffff",1536,2920,4456
"2478",1970-01-01 09:30:00,"88a8a07633fffff",437,1058,1495
"2479",1970-01-01 09:30:00,"88a8a07637fffff",485,1129,1614
"2480",1970-01-01 09:30:00,"88a8a076c7fffff",386,908,1294
"2481",1970-01-01 09:30:00,"88a8a076d1fffff",351,665,1016
"2482",1970-01-01 09:30:00,"88a8a076d3fffff",660,1360,2020
"2483",1970-01-01 09:30:00,"88a8a076d5fffff",431,900,1331
"2484",1970-01-01 09:30:00,"88a8a076d7fffff",332,679,1011
"2485",1970-01-01 09:30:00,"88a8a076e9fffff",374,876,1250
"2486",1970-01-01 09:30:00,"88a8a076ebfffff",273,656,929
"2487",1970-01-01 09:30:00,"88a8a076edfffff",425,1026,1451
"2488",1970-01-01 10:00:00,"88a8a02801fffff",234,606,840
"2489",1970-01-01 10:00:00,"88a8a02809fffff",234,606,840
"2490",1970-01-01 10:00:00,"88a8a0280bfffff",267,666,933
"2491",1970-01-01 10:00:00,"88a8a02853fffff",216,516,732
"2492",1970-01-01 10:00:00,"88a8a02857fffff",216,516,732
"2493",1970-01-01 10:00:00,"88a8a02a01fffff",153,450,603
"2494",1970-01-01 10:00:00,"88a8a02a05fffff",153,450,603
"2495",1970-01-01 10:00:00,"88a8a02a11fffff",155,449,604
"2496",1970-01-01 10:00:00,"88a8a02a13fffff",102,300,402
"2497",1970-01-01 10:00:00,"88a8a02a19fffff",203,520,723
"2498",1970-01-01 10:00:00,"88a8a02a61fffff",51,150,201
"2499",1970-01-01 10:00:00,"88a8a02a63fffff",102,300,402
"2500",1970-01-01 10:00:00,"88a8a02a69fffff",162,403,565
"2501",1970-01-01 10:00:00,"88a8a02a6bfffff",51,150,201
"2502",1970-01-01 10:00:00,"88a8a02a89fffff",290,809,1099
"2503",1970-01-01 10:00:00,"88a8a02a8bfffff",290,809,1099
"2504",1970-01-01 10:00:00,"88a8a02a9dfffff",135,360,495
"2505",1970-01-01 10:00:00,"88a8a02aadfffff",183,456,639
"2506",1970-01-01 10:00:00,"88a8a02ac5fffff",155,449,604
"2507",1970-01-01 10:00:00,"88a8a02ac7fffff",239,659,898
"2508",1970-01-01 10:00:00,"88a8a02ae3fffff",135,360,495
"2509",1970-01-01 10:00:00,"88a8a02ae7fffff",183,456,639
"2510",1970-01-01 10:00:00,"88a8a02aebfffff",84,210,294
"2511",1970-01-01 10:00:00,"88a8a03987fffff",291,562,853
"2512",1970-01-01 10:00:00,"88a8a03995fffff",180,309,489
"2513",1970-01-01 10:00:00,"88a8a03997fffff",222,506,728
"2514",1970-01-01 10:00:00,"88a8a039a1fffff",464,917,1381
"2515",1970-01-01 10:00:00,"88a8a039abfffff",471,871,1342
"2516",1970-01-01 10:00:00,"88a8a039adfffff",531,974,1505
"2517",1970-01-01 10:00:00,"88a8a039b9fffff",411,768,1179
"2518",1970-01-01 10:00:00,"88a8a039bbfffff",282,609,891
"2519",1970-01-01 10:00:00,"88a8a06081fffff",120,206,326
"2520",1970-01-01 10:00:00,"88a8a06085fffff",264,588,852
"2521",1970-01-01 10:00:00,"88a8a0608dfffff",520,1167,1687
"2522",1970-01-01 10:00:00,"88a8a060a3fffff",261,637,898
"2523",1970-01-01 10:00:00,"88a8a060a7fffff",60,103,163
"2524",1970-01-01 10:00:00,"88a8a060abfffff",159,337,496
"2525",1970-01-01 10:00:00,"88a8a060c1fffff",60,103,163
"2526",1970-01-01 10:00:00,"88a8a060c3fffff",414,869,1283
"2527",1970-01-01 10:00:00,"88a8a060c7fffff",465,1019,1484
"2528",1970-01-01 10:00:00,"88a8a060cbfffff",456,951,1407
"2529",1970-01-01 10:00:00,"88a8a06189fffff",0,0,0
"2530",1970-01-01 10:00:00,"88a8a0618bfffff",0,0,0
"2531",1970-01-01 10:00:00,"88a8a06193fffff",210,487,697
"2532",1970-01-01 10:00:00,"88a8a06197fffff",162,403,565
"2533",1970-01-01 10:00:00,"88a8a06199fffff",0,0,0
"2534",1970-01-01 10:00:00,"88a8a0619bfffff",51,150,201
"2535",1970-01-01 10:00:00,"88a8a061a1fffff",102,300,402
"2536",1970-01-01 10:00:00,"88a8a061a3fffff",102,300,402
"2537",1970-01-01 10:00:00,"88a8a061a5fffff",153,450,603
"2538",1970-01-01 10:00:00,"88a8a061adfffff",0,0,0
"2539",1970-01-01 10:00:00,"88a8a061b1fffff",303,834,1137
"2540",1970-01-01 10:00:00,"88a8a061b3fffff",363,937,1300
"2541",1970-01-01 10:00:00,"88a8a061b5fffff",150,384,534
"2542",1970-01-01 10:00:00,"88a8a061b7fffff",351,918,1269
"2543",1970-01-01 10:00:00,"88a8a06249fffff",659,1449,2108
"2544",1970-01-01 10:00:00,"88a8a0624bfffff",601,1345,1946
"2545",1970-01-01 10:00:00,"88a8a0624dfffff",701,1531,2232
"2546",1970-01-01 10:00:00,"88a8a06281fffff",354,651,1005
"2547",1970-01-01 10:00:00,"88a8a06283fffff",465,904,1369
"2548",1970-01-01 10:00:00,"88a8a06287fffff",465,904,1369
"2549",1970-01-01 10:00:00,"88a8a06289fffff",312,569,881
"2550",1970-01-01 10:00:00,"88a8a0628bfffff",162,288,450
"2551",1970-01-01 10:00:00,"88a8a06293fffff",291,562,853
"2552",1970-01-01 10:00:00,"88a8a06299fffff",231,459,690
"2553",1970-01-01 10:00:00,"88a8a0629bfffff",231,459,690
"2554",1970-01-01 10:00:00,"88a8a062b5fffff",576,1157,1733
"2555",1970-01-01 10:00:00,"88a8a062bdfffff",558,1136,1694
"2556",1970-01-01 10:00:00,"88a8a062c1fffff",186,349,535
"2557",1970-01-01 10:00:00,"88a8a062c3fffff",447,883,1330
"2558",1970-01-01 10:00:00,"88a8a062cbfffff",345,698,1043
"2559",1970-01-01 10:00:00,"88a8a062d1fffff",351,665,1016
"2560",1970-01-01 10:00:00,"88a8a062d3fffff",291,562,853
"2561",1970-01-01 10:00:00,"88a8a062d9fffff",462,918,1380
"2562",1970-01-01 10:00:00,"88a8a06541fffff",51,150,201
"2563",1970-01-01 10:00:00,"88a8a06549fffff",51,150,201
"2564",1970-01-01 10:00:00,"88a8a06705fffff",300,515,815
"2565",1970-01-01 10:00:00,"88a8a06707fffff",111,253,364
"2566",1970-01-01 10:00:00,"88a8a0670dfffff",120,206,326
"2567",1970-01-01 10:00:00,"88a8a0672bfffff",111,253,364
"2568",1970-01-01 10:00:00,"88a8a06731fffff",51,150,201
"2569",1970-01-01 10:00:00,"88a8a06735fffff",51,150,201
"2570",1970-01-01 10:00:00,"88a8a06739fffff",111,253,364
"2571",1970-01-01 10:00:00,"88a8a0674dfffff",180,309,489
"2572",1970-01-01 10:00:00,"88a8a0676bfffff",111,253,364
"2573",1970-01-01 10:00:00,"88a8a06a91fffff",153,450,603
"2574",1970-01-01 10:00:00,"88a8a06a9bfffff",153,450,603
"2575",1970-01-01 10:00:00,"88a8a06e49fffff",261,637,898
"2576",1970-01-01 10:00:00,"88a8a06e4dfffff",261,637,898
"2577",1970-01-01 10:00:00,"88a8a06e69fffff",150,384,534
"2578",1970-01-01 10:00:00,"88a8a06e6dfffff",363,937,1300
"2579",1970-01-01 10:00:00,"88a8a06f05fffff",102,300,402
"2580",1970-01-01 10:00:00,"88a8a06f61fffff",102,300,402
"2581",1970-01-01 10:00:00,"88a8a06f63fffff",102,300,402
"2582",1970-01-01 10:00:00,"88a8a06f67fffff",153,450,603
"2583",1970-01-01 10:00:00,"88a8a06f69fffff",153,450,603
"2584",1970-01-01 10:00:00,"88a8a070b3fffff",499,1160,1659
"2585",1970-01-01 10:00:00,"88a8a070b7fffff",559,1263,1822
"2586",1970-01-01 10:00:00,"88a8a07193fffff",60,103,163
"2587",1970-01-01 10:00:00,"88a8a0719bfffff",548,1196,1744
"2588",1970-01-01 10:00:00,"88a8a07441fffff",402,815,1217
"2589",1970-01-01 10:00:00,"88a8a07445fffff",288,483,771
"2590",1970-01-01 10:00:00,"88a8a07447fffff",222,506,728
"2591",1970-01-01 10:00:00,"88a8a0744bfffff",291,562,853
"2592",1970-01-01 10:00:00,"88a8a07461fffff",887,1829,2716
"2593",1970-01-01 10:00:00,"88a8a07465fffff",614,1288,1902
"2594",1970-01-01 10:00:00,"88a8a07467fffff",222,391,613
"2595",1970-01-01 10:00:00,"88a8a07469fffff",333,759,1092
"2596",1970-01-01 10:00:00,"88a8a0746bfffff",831,1716,2547
"2597",1970-01-01 10:00:00,"88a8a07503fffff",0,0,0
"2598",1970-01-01 10:00:00,"88a8a07507fffff",566,1102,1668
"2599",1970-01-01 10:00:00,"88a8a07515fffff",411,768,1179
"2600",1970-01-01 10:00:00,"88a8a0751dfffff",180,309,489
"2601",1970-01-01 10:00:00,"88a8a07521fffff",769,1532,2301
"2602",1970-01-01 10:00:00,"88a8a07525fffff",375,726,1101
"2603",1970-01-01 10:00:00,"88a8a0752bfffff",709,1429,2138
"2604",1970-01-01 10:00:00,"88a8a0752dfffff",778,1600,2378
"2605",1970-01-01 10:00:00,"88a8a07531fffff",1029,2007,3036
"2606",1970-01-01 10:00:00,"88a8a07533fffff",351,665,1016
"2607",1970-01-01 10:00:00,"88a8a07535fffff",387,780,1167
"2608",1970-01-01 10:00:00,"88a8a07537fffff",411,768,1179
"2609",1970-01-01 10:00:00,"88a8a07539fffff",790,1607,2397
"2610",1970-01-01 10:00:00,"88a8a0753bfffff",204,485,689
"2611",1970-01-01 10:00:00,"88a8a0753dfffff",476,971,1447
"2612",1970-01-01 10:00:00,"88a8a07543fffff",434,979,1413
"2613",1970-01-01 10:00:00,"88a8a07545fffff",318,648,966
"2614",1970-01-01 10:00:00,"88a8a07547fffff",374,876,1250
"2615",1970-01-01 10:00:00,"88a8a07553fffff",222,391,613
"2616",1970-01-01 10:00:00,"88a8a07557fffff",120,206,326
"2617",1970-01-01 10:00:00,"88a8a07559fffff",335,758,1093
"2618",1970-01-01 10:00:00,"88a8a0755bfffff",180,309,489
"2619",1970-01-01 10:00:00,"88a8a0755dfffff",371,797,1168
"2620",1970-01-01 10:00:00,"88a8a07561fffff",889,1853,2742
"2621",1970-01-01 10:00:00,"88a8a07565fffff",0,0,0
"2622",1970-01-01 10:00:00,"88a8a07567fffff",820,1797,2617
"2623",1970-01-01 10:00:00,"88a8a07569fffff",480,1051,1531
"2624",1970-01-01 10:00:00,"88a8a0756bfffff",111,253,364
"2625",1970-01-01 10:00:00,"88a8a0756dfffff",1129,2377,3506
"2626",1970-01-01 10:00:00,"88a8a07633fffff",393,862,1255
"2627",1970-01-01 10:00:00,"88a8a07637fffff",231,459,690
"2628",1970-01-01 10:00:00,"88a8a076c7fffff",111,253,364
"2629",1970-01-01 10:00:00,"88a8a076d1fffff",360,618,978
"2630",1970-01-01 10:00:00,"88a8a076d3fffff",584,1123,1707
"2631",1970-01-01 10:00:00,"88a8a076d5fffff",533,973,1506
"2632",1970-01-01 10:00:00,"88a8a076d7fffff",284,608,892
"2633",1970-01-01 10:00:00,"88a8a076e9fffff",222,506,728
"2634",1970-01-01 10:00:00,"88a8a076ebfffff",171,356,527
"2635",1970-01-01 10:00:00,"88a8a076edfffff",282,609,891
"2636",1970-01-01 10:30:00,"88a8a02801fffff",33,60,93
"2637",1970-01-01 10:30:00,"88a8a02805fffff",33,60,93
"2638",1970-01-01 10:30:00,"88a8a02809fffff",0,0,0
"2639",1970-01-01 10:30:00,"88a8a0280bfffff",33,60,93
"2640",1970-01-01 10:30:00,"88a8a02829fffff",33,60,93
"2641",1970-01-01 10:30:00,"88a8a0282dfffff",33,60,93
"2642",1970-01-01 10:30:00,"88a8a02853fffff",33,60,93
"2643",1970-01-01 10:30:00,"88a8a02857fffff",33,60,93
"2644",1970-01-01 10:30:00,"88a8a02953fffff",33,60,93
"2645",1970-01-01 10:30:00,"88a8a02a01fffff",212,473,685
"2646",1970-01-01 10:30:00,"88a8a02a05fffff",314,773,1087
"2647",1970-01-01 10:30:00,"88a8a02a09fffff",0,0,0
"2648",1970-01-01 10:30:00,"88a8a02a0bfffff",152,370,522
"2649",1970-01-01 10:30:00,"88a8a02a0dfffff",99,221,320
"2650",1970-01-01 10:30:00,"88a8a02a11fffff",111,253,364
"2651",1970-01-01 10:30:00,"88a8a02a13fffff",162,403,565
"2652",1970-01-01 10:30:00,"88a8a02a19fffff",111,253,364
"2653",1970-01-01 10:30:00,"88a8a02a57fffff",212,473,685
"2654",1970-01-01 10:30:00,"88a8a02a61fffff",113,252,365
"2655",1970-01-01 10:30:00,"88a8a02a63fffff",224,505,729
"2656",1970-01-01 10:30:00,"88a8a02a69fffff",215,552,767
"2657",1970-01-01 10:30:00,"88a8a02a6bfffff",102,300,402
"2658",1970-01-01 10:30:00,"88a8a02a89fffff",246,613,859
"2659",1970-01-01 10:30:00,"88a8a02a8bfffff",246,613,859
"2660",1970-01-01 10:30:00,"88a8a02a9dfffff",51,150,201
"2661",1970-01-01 10:30:00,"88a8a02aadfffff",33,60,93
"2662",1970-01-01 10:30:00,"88a8a02ac5fffff",162,403,565
"2663",1970-01-01 10:30:00,"88a8a02ac7fffff",195,463,658
"2664",1970-01-01 10:30:00,"88a8a02ae3fffff",33,60,93
"2665",1970-01-01 10:30:00,"88a8a02ae7fffff",33,60,93
"2666",1970-01-01 10:30:00,"88a8a02aebfffff",33,60,93
"2667",1970-01-01 10:30:00,"88a8a03987fffff",60,103,163
"2668",1970-01-01 10:30:00,"88a8a03995fffff",275,655,930
"2669",1970-01-01 10:30:00,"88a8a03997fffff",215,552,767
"2670",1970-01-01 10:30:00,"88a8a039a1fffff",583,1554,2137
"2671",1970-01-01 10:30:00,"88a8a039abfffff",539,1358,1897
"2672",1970-01-01 10:30:00,"88a8a039adfffff",583,1554,2137
"2673",1970-01-01 10:30:00,"88a8a039b9fffff",446,1011,1457
"2674",1970-01-01 10:30:00,"88a8a039bbfffff",335,758,1093
"2675",1970-01-01 10:30:00,"88a8a039bdfffff",264,703,967
"2676",1970-01-01 10:30:00,"88a8a06081fffff",84,164,248
"2677",1970-01-01 10:30:00,"88a8a06085fffff",462,941,1403
"2678",1970-01-01 10:30:00,"88a8a0608dfffff",669,1377,2046
"2679",1970-01-01 10:30:00,"88a8a060a3fffff",303,719,1022
"2680",1970-01-01 10:30:00,"88a8a060a7fffff",42,82,124
"2681",1970-01-01 10:30:00,"88a8a060abfffff",243,501,744
"2682",1970-01-01 10:30:00,"88a8a060c1fffff",42,82,124
"2683",1970-01-01 10:30:00,"88a8a060c3fffff",366,658,1024
"2684",1970-01-01 10:30:00,"88a8a060c7fffff",384,679,1063
"2685",1970-01-01 10:30:00,"88a8a060cbfffff",426,876,1302
"2686",1970-01-01 10:30:00,"88a8a06193fffff",255,635,890
"2687",1970-01-01 10:30:00,"88a8a06197fffff",195,532,727
"2688",1970-01-01 10:30:00,"88a8a0619bfffff",42,82,124
"2689",1970-01-01 10:30:00,"88a8a061a1fffff",102,300,402
"2690",1970-01-01 10:30:00,"88a8a061a3fffff",102,300,402
"2691",1970-01-01 10:30:00,"88a8a061a5fffff",102,300,402
"2692",1970-01-01 10:30:00,"88a8a061b1fffff",171,356,527
"2693",1970-01-01 10:30:00,"88a8a061b3fffff",144,382,526
"2694",1970-01-01 10:30:00,"88a8a061b5fffff",102,300,402
"2695",1970-01-01 10:30:00,"88a8a061b7fffff",333,759,1092
"2696",1970-01-01 10:30:00,"88a8a06249fffff",457,1010,1467
"2697",1970-01-01 10:30:00,"88a8a0624bfffff",455,1011,1466
"2698",1970-01-01 10:30:00,"88a8a0624dfffff",559,1310,1869
"2699",1970-01-01 10:30:00,"88a8a06281fffff",144,382,526
"2700",1970-01-01 10:30:00,"88a8a06283fffff",357,935,1292
"2701",1970-01-01 10:30:00,"88a8a06287fffff",477,1141,1618
"2702",1970-01-01 10:30:00,"88a8a06289fffff",417,1038,1455
"2703",1970-01-01 10:30:00,"88a8a0628bfffff",264,703,967
"2704",1970-01-01 10:30:00,"88a8a06293fffff",120,206,326
"2705",1970-01-01 10:30:00,"88a8a06299fffff",120,206,326
"2706",1970-01-01 10:30:00,"88a8a0629bfffff",120,206,326
"2707",1970-01-01 10:30:00,"88a8a062b5fffff",375,841,1216
"2708",1970-01-01 10:30:00,"88a8a062bdfffff",375,841,1216
"2709",1970-01-01 10:30:00,"88a8a062c1fffff",60,103,163
"2710",1970-01-01 10:30:00,"88a8a062c3fffff",348,867,1215
"2711",1970-01-01 10:30:00,"88a8a062cbfffff",408,970,1378
"2712",1970-01-01 10:30:00,"88a8a062d1fffff",231,459,690
"2713",1970-01-01 10:30:00,"88a8a062d3fffff",60,103,163
"2714",1970-01-01 10:30:00,"88a8a062d9fffff",171,356,527
"2715",1970-01-01 10:30:00,"88a8a06541fffff",60,103,163
"2716",1970-01-01 10:30:00,"88a8a06549fffff",120,206,326
"2717",1970-01-01 10:30:00,"88a8a06705fffff",231,459,690
"2718",1970-01-01 10:30:00,"88a8a06707fffff",111,253,364
"2719",1970-01-01 10:30:00,"88a8a0670dfffff",111,253,364
"2720",1970-01-01 10:30:00,"88a8a0672bfffff",111,253,364
"2721",1970-01-01 10:30:00,"88a8a06731fffff",111,253,364
"2722",1970-01-01 10:30:00,"88a8a06735fffff",171,356,527
"2723",1970-01-01 10:30:00,"88a8a06739fffff",111,253,364
"2724",1970-01-01 10:30:00,"88a8a0674dfffff",120,206,326
"2725",1970-01-01 10:30:00,"88a8a0676bfffff",291,562,853
"2726",1970-01-01 10:30:00,"88a8a06a91fffff",51,150,201
"2727",1970-01-01 10:30:00,"88a8a06a9bfffff",153,450,603
"2728",1970-01-01 10:30:00,"88a8a06e49fffff",243,616,859
"2729",1970-01-01 10:30:00,"88a8a06e4dfffff",255,635,890
"2730",1970-01-01 10:30:00,"88a8a06e69fffff",102,300,402
"2731",1970-01-01 10:30:00,"88a8a06e6dfffff",213,553,766
"2732",1970-01-01 10:30:00,"88a8a06f05fffff",51,150,201
"2733",1970-01-01 10:30:00,"88a8a06f61fffff",102,300,402
"2734",1970-01-01 10:30:00,"88a8a06f63fffff",102,300,402
"2735",1970-01-01 10:30:00,"88a8a06f67fffff",51,150,201
"2736",1970-01-01 10:30:00,"88a8a06f69fffff",102,300,402
"2737",1970-01-01 10:30:00,"88a8a070b3fffff",555,1197,1752
"2738",1970-01-01 10:30:00,"88a8a070b7fffff",455,1011,1466
"2739",1970-01-01 10:30:00,"88a8a0719bfffff",296,662,958
"2740",1970-01-01 10:30:00,"88a8a07441fffff",453,965,1418
"2741",1970-01-01 10:30:00,"88a8a07445fffff",171,356,527
"2742",1970-01-01 10:30:00,"88a8a07447fffff",342,712,1054
"2743",1970-01-01 10:30:00,"88a8a0744bfffff",615,1368,1983
"2744",1970-01-01 10:30:00,"88a8a07461fffff",681,1370,2051
"2745",1970-01-01 10:30:00,"88a8a07465fffff",575,1170,1745
"2746",1970-01-01 10:30:00,"88a8a07467fffff",108,199,307
"2747",1970-01-01 10:30:00,"88a8a07469fffff",108,199,307
"2748",1970-01-01 10:30:00,"88a8a0746bfffff",510,1014,1524
"2749",1970-01-01 10:30:00,"88a8a07503fffff",171,356,527
"2750",1970-01-01 10:30:00,"88a8a07507fffff",597,1232,1829
"2751",1970-01-01 10:30:00,"88a8a07509fffff",0,0,0
"2752",1970-01-01 10:30:00,"88a8a07515fffff",450,911,1361
"2753",1970-01-01 10:30:00,"88a8a0751dfffff",219,452,671
"2754",1970-01-01 10:30:00,"88a8a07521fffff",579,1326,1905
"2755",1970-01-01 10:30:00,"88a8a07525fffff",255,520,775
"2756",1970-01-01 10:30:00,"88a8a0752bfffff",690,1579,2269
"2757",1970-01-01 10:30:00,"88a8a0752dfffff",579,1326,1905
"2758",1970-01-01 10:30:00,"88a8a07531fffff",819,1738,2557
"2759",1970-01-01 10:30:00,"88a8a07533fffff",180,309,489
"2760",1970-01-01 10:30:00,"88a8a07535fffff",408,970,1378
"2761",1970-01-01 10:30:00,"88a8a07537fffff",231,459,690
"2762",1970-01-01 10:30:00,"88a8a07539fffff",846,1712,2558
"2763",1970-01-01 10:30:00,"88a8a0753bfffff",108,199,307
"2764",1970-01-01 10:30:00,"88a8a0753dfffff",408,970,1378
"2765",1970-01-01 10:30:00,"88a8a07543fffff",752,1400,2152
"2766",1970-01-01 10:30:00,"88a8a07545fffff",353,664,1017
"2767",1970-01-01 10:30:00,"88a8a07547fffff",692,1297,1989
"2768",1970-01-01 10:30:00,"88a8a07553fffff",219,452,671
"2769",1970-01-01 10:30:00,"88a8a07557fffff",159,349,508
"2770",1970-01-01 10:30:00,"88a8a07559fffff",644,1226,1870
"2771",1970-01-01 10:30:00,"88a8a0755bfffff",219,452,671
"2772",1970-01-01 10:30:00,"88a8a0755dfffff",641,1147,1788
"2773",1970-01-01 10:30:00,"88a8a07561fffff",435,944,1379
"2774",1970-01-01 10:30:00,"88a8a07565fffff",60,103,163
"2775",1970-01-01 10:30:00,"88a8a07567fffff",477,1026,1503
"2776",1970-01-01 10:30:00,"88a8a07569fffff",574,1090,1664
"2777",1970-01-01 10:30:00,"88a8a0756bfffff",401,735,1136
"2778",1970-01-01 10:30:00,"88a8a0756dfffff",922,1982,2904
"2779",1970-01-01 10:30:00,"88a8a07633fffff",444,1012,1456
"2780",1970-01-01 10:30:00,"88a8a07637fffff",555,1265,1820
"2781",1970-01-01 10:30:00,"88a8a076c7fffff",384,909,1293
"2782",1970-01-01 10:30:00,"88a8a076d1fffff",275,655,930
"2783",1970-01-01 10:30:00,"88a8a076d3fffff",488,1208,1696
"2784",1970-01-01 10:30:00,"88a8a076d5fffff",317,852,1169
"2785",1970-01-01 10:30:00,"88a8a076d7fffff",162,403,565
"2786",1970-01-01 10:30:00,"88a8a076e9fffff",324,806,1130
"2787",1970-01-01 10:30:00,"88a8a076ebfffff",384,909,1293
"2788",1970-01-01 10:30:00,"88a8a076edfffff",437,1058,1495
"2789",1970-01-01 11:00:00,"88a8a02801fffff",51,150,201
"2790",1970-01-01 11:00:00,"88a8a02809fffff",51,150,201
"2791",1970-01-01 11:00:00,"88a8a0280bfffff",99,221,320
"2792",1970-01-01 11:00:00,"88a8a02825fffff",33,60,93
"2793",1970-01-01 11:00:00,"88a8a02829fffff",33,60,93
"2794",1970-01-01 11:00:00,"88a8a0282dfffff",33,60,93
"2795",1970-01-01 11:00:00,"88a8a02853fffff",141,303,444
"2796",1970-01-01 11:00:00,"88a8a02857fffff",99,221,320
"2797",1970-01-01 11:00:00,"88a8a02919fffff",33,60,93
"2798",1970-01-01 11:00:00,"88a8a0291dfffff",33,60,93
"2799",1970-01-01 11:00:00,"88a8a02953fffff",33,60,93
"2800",1970-01-01 11:00:00,"88a8a02a01fffff",270,577,847
"2801",1970-01-01 11:00:00,"88a8a02a05fffff",222,506,728
"2802",1970-01-01 11:00:00,"88a8a02a0bfffff",99,221,320
"2803",1970-01-01 11:00:00,"88a8a02a0dfffff",60,103,163
"2804",1970-01-01 11:00:00,"88a8a02a11fffff",150,371,521
"2805",1970-01-01 11:00:00,"88a8a02a13fffff",99,221,320
"2806",1970-01-01 11:00:00,"88a8a02a19fffff",150,371,521
"2807",1970-01-01 11:00:00,"88a8a02a57fffff",150,371,521
"2808",1970-01-01 11:00:00,"88a8a02a61fffff",60,103,163
"2809",1970-01-01 11:00:00,"88a8a02a63fffff",171,356,527
"2810",1970-01-01 11:00:00,"88a8a02a69fffff",222,506,728
"2811",1970-01-01 11:00:00,"88a8a02a6bfffff",51,150,201
"2812",1970-01-01 11:00:00,"88a8a02a89fffff",102,300,402
"2813",1970-01-01 11:00:00,"88a8a02a8bfffff",102,300,402
"2814",1970-01-01 11:00:00,"88a8a02a9dfffff",204,600,804
"2815",1970-01-01 11:00:00,"88a8a02aa9fffff",51,150,201
"2816",1970-01-01 11:00:00,"88a8a02aadfffff",141,303,444
"2817",1970-01-01 11:00:00,"88a8a02ac5fffff",99,221,320
"2818",1970-01-01 11:00:00,"88a8a02ac7fffff",201,521,722
"2819",1970-01-01 11:00:00,"88a8a02ae3fffff",141,303,444
"2820",1970-01-01 11:00:00,"88a8a02ae7fffff",141,303,444
"2821",1970-01-01 11:00:00,"88a8a02aebfffff",99,221,320
"2822",1970-01-01 11:00:00,"88a8a03987fffff",270,577,847
"2823",1970-01-01 11:00:00,"88a8a03995fffff",282,609,891
"2824",1970-01-01 11:00:00,"88a8a03997fffff",213,553,766
"2825",1970-01-01 11:00:00,"88a8a039a1fffff",270,577,847
"2826",1970-01-01 11:00:00,"88a8a039abfffff",330,680,1010
"2827",1970-01-01 11:00:00,"88a8a039adfffff",330,680,1010
"2828",1970-01-01 11:00:00,"88a8a039b9fffff",330,680,1010
"2829",1970-01-01 11:00:00,"88a8a039bbfffff",381,830,1211
"2830",1970-01-01 11:00:00,"88a8a06085fffff",405,1031,1436
"2831",1970-01-01 11:00:00,"88a8a0608dfffff",357,935,1292
"2832",1970-01-01 11:00:00,"88a8a060a3fffff",195,417,612
"2833",1970-01-01 11:00:00,"88a8a060a7fffff",0,0,0
"2834",1970-01-01 11:00:00,"88a8a060abfffff",195,532,727
"2835",1970-01-01 11:00:00,"88a8a060c1fffff",60,103,163
"2836",1970-01-01 11:00:00,"88a8a060c3fffff",357,935,1292
"2837",1970-01-01 11:00:00,"88a8a060c7fffff",357,935,1292
"2838",1970-01-01 11:00:00,"88a8a060cbfffff",366,888,1254
"2839",1970-01-01 11:00:00,"88a8a06193fffff",228,546,774
"2840",1970-01-01 11:00:00,"88a8a06197fffff",243,501,744
"2841",1970-01-01 11:00:00,"88a8a0619bfffff",144,382,526
"2842",1970-01-01 11:00:00,"88a8a061a1fffff",99,234,333
"2843",1970-01-01 11:00:00,"88a8a061a3fffff",150,384,534
"2844",1970-01-01 11:00:00,"88a8a061a5fffff",201,534,735
"2845",1970-01-01 11:00:00,"88a8a061b1fffff",42,82,124
"2846",1970-01-01 11:00:00,"88a8a061b3fffff",312,672,984
"2847",1970-01-01 11:00:00,"88a8a061b5fffff",210,487,697
"2848",1970-01-01 11:00:00,"88a8a061b7fffff",354,754,1108
"2849",1970-01-01 11:00:00,"88a8a06249fffff",467,903,1370
"2850",1970-01-01 11:00:00,"88a8a0624bfffff",467,903,1370
"2851",1970-01-01 11:00:00,"88a8a0624dfffff",587,1109,1696
"2852",1970-01-01 11:00:00,"88a8a06281fffff",141,328,469
"2853",1970-01-01 11:00:00,"88a8a06283fffff",303,731,1034
"2854",1970-01-01 11:00:00,"88a8a06287fffff",252,581,833
"2855",1970-01-01 11:00:00,"88a8a06289fffff",414,984,1398
"2856",1970-01-01 11:00:00,"88a8a0628bfffff",159,349,508
"2857",1970-01-01 11:00:00,"88a8a06293fffff",60,103,163
"2858",1970-01-01 11:00:00,"88a8a06299fffff",120,206,326
"2859",1970-01-01 11:00:00,"88a8a0629bfffff",120,206,326
"2860",1970-01-01 11:00:00,"88a8a062b5fffff",303,731,1034
"2861",1970-01-01 11:00:00,"88a8a062bdfffff",303,731,1034
"2862",1970-01-01 11:00:00,"88a8a062c1fffff",51,150,201
"2863",1970-01-01 11:00:00,"88a8a062c3fffff",321,752,1073
"2864",1970-01-01 11:00:00,"88a8a062cbfffff",270,602,872
"2865",1970-01-01 11:00:00,"88a8a062d1fffff",173,355,528
"2866",1970-01-01 11:00:00,"88a8a062d3fffff",120,206,326
"2867",1970-01-01 11:00:00,"88a8a062d9fffff",173,355,528
"2868",1970-01-01 11:00:00,"88a8a06541fffff",60,103,163
"2869",1970-01-01 11:00:00,"88a8a06549fffff",120,206,326
"2870",1970-01-01 11:00:00,"88a8a06705fffff",180,309,489
"2871",1970-01-01 11:00:00,"88a8a06707fffff",60,103,163
"2872",1970-01-01 11:00:00,"88a8a0670dfffff",60,103,163
"2873",1970-01-01 11:00:00,"88a8a0672bfffff",60,103,163
"2874",1970-01-01 11:00:00,"88a8a06731fffff",60,103,163
"2875",1970-01-01 11:00:00,"88a8a06735fffff",120,206,326
"2876",1970-01-01 11:00:00,"88a8a06739fffff",120,206,326
"2877",1970-01-01 11:00:00,"88a8a0676bfffff",240,412,652
"2878",1970-01-01 11:00:00,"88a8a06a91fffff",201,534,735
"2879",1970-01-01 11:00:00,"88a8a06a9bfffff",150,384,534
"2880",1970-01-01 11:00:00,"88a8a06e49fffff",246,567,813
"2881",1970-01-01 11:00:00,"88a8a06e4dfffff",288,649,937
"2882",1970-01-01 11:00:00,"88a8a06e69fffff",51,150,201
"2883",1970-01-01 11:00:00,"88a8a06e6dfffff",252,569,821
"2884",1970-01-01 11:00:00,"88a8a06f63fffff",51,150,201
"2885",1970-01-01 11:00:00,"88a8a06f67fffff",51,150,201
"2886",1970-01-01 11:00:00,"88a8a06f69fffff",51,150,201
"2887",1970-01-01 11:00:00,"88a8a070b3fffff",418,867,1285
"2888",1970-01-01 11:00:00,"88a8a070b7fffff",467,903,1370
"2889",1970-01-01 11:00:00,"88a8a0719bfffff",402,700,1102
"2890",1970-01-01 11:00:00,"88a8a07441fffff",485,1129,1614
"2891",1970-01-01 11:00:00,"88a8a07445fffff",288,483,771
"2892",1970-01-01 11:00:00,"88a8a07447fffff",326,805,1131
"2893",1970-01-01 11:00:00,"88a8a0744bfffff",321,727,1048
"2894",1970-01-01 11:00:00,"88a8a07461fffff",692,1578,2270
"2895",1970-01-01 11:00:00,"88a8a07465fffff",386,908,1294
"2896",1970-01-01 11:00:00,"88a8a07467fffff",144,267,411
"2897",1970-01-01 11:00:00,"88a8a07469fffff",225,492,717
"2898",1970-01-01 11:00:00,"88a8a0746bfffff",677,1492,2169
"2899",1970-01-01 11:00:00,"88a8a07503fffff",42,82,124
"2900",1970-01-01 11:00:00,"88a8a07507fffff",321,637,958
"2901",1970-01-01 11:00:00,"88a8a07515fffff",248,566,814
"2902",1970-01-01 11:00:00,"88a8a0751dfffff",195,417,612
"2903",1970-01-01 11:00:00,"88a8a07521fffff",445,956,1401
"2904",1970-01-01 11:00:00,"88a8a07525fffff",173,355,528
"2905",1970-01-01 11:00:00,"88a8a0752bfffff",478,1085,1563
"2906",1970-01-01 11:00:00,"88a8a0752dfffff",436,1003,1439
"2907",1970-01-01 11:00:00,"88a8a07531fffff",605,1360,1965
"2908",1970-01-01 11:00:00,"88a8a07533fffff",0,0,0
"2909",1970-01-01 11:00:00,"88a8a07535fffff",321,752,1073
"2910",1970-01-01 11:00:00,"88a8a07537fffff",113,252,365
"2911",1970-01-01 11:00:00,"88a8a07539fffff",349,811,1160
"2912",1970-01-01 11:00:00,"88a8a0753dfffff",254,695,949
"2913",1970-01-01 11:00:00,"88a8a07543fffff",326,805,1131
"2914",1970-01-01 11:00:00,"88a8a07545fffff",171,356,527
"2915",1970-01-01 11:00:00,"88a8a07547fffff",326,805,1131
"2916",1970-01-01 11:00:00,"88a8a07553fffff",195,417,612
"2917",1970-01-01 11:00:00,"88a8a07557fffff",93,232,325
"2918",1970-01-01 11:00:00,"88a8a07559fffff",326,805,1131
"2919",1970-01-01 11:00:00,"88a8a0755bfffff",135,314,449
"2920",1970-01-01 11:00:00,"88a8a0755dfffff",326,805,1131
"2921",1970-01-01 11:00:00,"88a8a07561fffff",406,813,1219
"2922",1970-01-01 11:00:00,"88a8a07565fffff",166,401,567
"2923",1970-01-01 11:00:00,"88a8a07567fffff",556,1209,1765
"2924",1970-01-01 11:00:00,"88a8a07569fffff",284,608,892
"2925",1970-01-01 11:00:00,"88a8a0756bfffff",275,655,930
"2926",1970-01-01 11:00:00,"88a8a0756dfffff",723,1665,2388
"2927",1970-01-01 11:00:00,"88a8a07633fffff",321,727,1048
"2928",1970-01-01 11:00:00,"88a8a07637fffff",381,830,1211
"2929",1970-01-01 11:00:00,"88a8a076c7fffff",168,277,445
"2930",1970-01-01 11:00:00,"88a8a076d1fffff",180,309,489
"2931",1970-01-01 11:00:00,"88a8a076d3fffff",231,459,690
"2932",1970-01-01 11:00:00,"88a8a076d5fffff",222,506,728
"2933",1970-01-01 11:00:00,"88a8a076d7fffff",162,403,565
"2934",1970-01-01 11:00:00,"88a8a076e9fffff",219,427,646
"2935",1970-01-01 11:00:00,"88a8a076ebfffff",60,103,163
"2936",1970-01-01 11:00:00,"88a8a076edfffff",321,727,1048
"2937",1970-01-01 11:30:00,"88a8a02801fffff",123,213,336
"2938",1970-01-01 11:30:00,"88a8a02805fffff",33,60,93
"2939",1970-01-01 11:30:00,"88a8a02809fffff",90,153,243
"2940",1970-01-01 11:30:00,"88a8a0280bfffff",75,142,217
"2941",1970-01-01 11:30:00,"88a8a02853fffff",33,60,93
"2942",1970-01-01 11:30:00,"88a8a02857fffff",75,142,217
"2943",1970-01-01 11:30:00,"88a8a0285bfffff",0,0,0
"2944",1970-01-01 11:30:00,"88a8a02a01fffff",99,221,320
"2945",1970-01-01 11:30:00,"88a8a02a05fffff",147,292,439
"2946",1970-01-01 11:30:00,"88a8a02a0dfffff",48,71,119
"2947",1970-01-01 11:30:00,"88a8a02a11fffff",51,150,201
"2948",1970-01-01 11:30:00,"88a8a02a13fffff",0,0,0
"2949",1970-01-01 11:30:00,"88a8a02a17fffff",0,0,0
"2950",1970-01-01 11:30:00,"88a8a02a19fffff",51,150,201
"2951",1970-01-01 11:30:00,"88a8a02a3bfffff",0,0,0
"2952",1970-01-01 11:30:00,"88a8a02a57fffff",51,150,201
"2953",1970-01-01 11:30:00,"88a8a02a61fffff",0,0,0
"2954",1970-01-01 11:30:00,"88a8a02a63fffff",99,221,320
"2955",1970-01-01 11:30:00,"88a8a02a69fffff",102,300,402
"2956",1970-01-01 11:30:00,"88a8a02a89fffff",195,463,658
"2957",1970-01-01 11:30:00,"88a8a02a8bfffff",306,716,1022
"2958",1970-01-01 11:30:00,"88a8a02a9dfffff",93,163,256
"2959",1970-01-01 11:30:00,"88a8a02aadfffff",33,60,93
"2960",1970-01-01 11:30:00,"88a8a02ac5fffff",111,253,364
"2961",1970-01-01 11:30:00,"88a8a02ac7fffff",162,403,565
"2962",1970-01-01 11:30:00,"88a8a02ae5fffff",0,0,0
"2963",1970-01-01 11:30:00,"88a8a03987fffff",111,253,364
"2964",1970-01-01 11:30:00,"88a8a03995fffff",99,221,320
"2965",1970-01-01 11:30:00,"88a8a03997fffff",153,450,603
"2966",1970-01-01 11:30:00,"88a8a039a1fffff",273,656,929
"2967",1970-01-01 11:30:00,"88a8a039abfffff",266,702,968
"2968",1970-01-01 11:30:00,"88a8a039adfffff",266,702,968
"2969",1970-01-01 11:30:00,"88a8a039b9fffff",324,806,1130
"2970",1970-01-01 11:30:00,"88a8a039bbfffff",273,656,929
"2971",1970-01-01 11:30:00,"88a8a039bdfffff",60,103,163
"2972",1970-01-01 11:30:00,"88a8a06085fffff",516,1284,1800
"2973",1970-01-01 11:30:00,"88a8a0608dfffff",738,1790,2528
"2974",1970-01-01 11:30:00,"88a8a060a3fffff",252,581,833
"2975",1970-01-01 11:30:00,"88a8a060abfffff",312,799,1111
"2976",1970-01-01 11:30:00,"88a8a060c1fffff",144,382,526
"2977",1970-01-01 11:30:00,"88a8a060c3fffff",518,1283,1801
"2978",1970-01-01 11:30:00,"88a8a060c7fffff",414,984,1398
"2979",1970-01-01 11:30:00,"88a8a060cbfffff",518,1283,1801
"2980",1970-01-01 11:30:00,"88a8a06193fffff",210,499,709
"2981",1970-01-01 11:30:00,"88a8a06197fffff",210,499,709
"2982",1970-01-01 11:30:00,"88a8a0619bfffff",99,246,345
"2983",1970-01-01 11:30:00,"88a8a061a1fffff",144,382,526
"2984",1970-01-01 11:30:00,"88a8a061a3fffff",150,396,546
"2985",1970-01-01 11:30:00,"88a8a061a5fffff",135,314,449
"2986",1970-01-01 11:30:00,"88a8a061adfffff",0,0,0
"2987",1970-01-01 11:30:00,"88a8a061b1fffff",201,431,632
"2988",1970-01-01 11:30:00,"88a8a061b3fffff",303,731,1034
"2989",1970-01-01 11:30:00,"88a8a061b5fffff",192,478,670
"2990",1970-01-01 11:30:00,"88a8a061b7fffff",351,827,1178
"2991",1970-01-01 11:30:00,"88a8a061e7fffff",0,0,0
"2992",1970-01-01 11:30:00,"88a8a06249fffff",270,487,757
"2993",1970-01-01 11:30:00,"88a8a0624bfffff",270,487,757
"2994",1970-01-01 11:30:00,"88a8a0624dfffff",348,611,959
"2995",1970-01-01 11:30:00,"88a8a06281fffff",365,833,1198
"2996",1970-01-01 11:30:00,"88a8a06283fffff",509,1215,1724
"2997",1970-01-01 11:30:00,"88a8a06287fffff",587,1339,1926
"2998",1970-01-01 11:30:00,"88a8a06289fffff",356,880,1236
"2999",1970-01-01 11:30:00,"88a8a0628bfffff",144,382,526
"3000",1970-01-01 11:30:00,"88a8a06293fffff",53,149,202
"3001",1970-01-01 11:30:00,"88a8a0629bfffff",53,149,202
"3002",1970-01-01 11:30:00,"88a8a062b5fffff",470,1187,1657
"3003",1970-01-01 11:30:00,"88a8a062bdfffff",638,1489,2127
"3004",1970-01-01 11:30:00,"88a8a062c1fffff",245,627,872
"3005",1970-01-01 11:30:00,"88a8a062c3fffff",305,730,1035
"3006",1970-01-01 11:30:00,"88a8a062cbfffff",356,880,1236
"3007",1970-01-01 11:30:00,"88a8a062d1fffff",60,103,163
"3008",1970-01-01 11:30:00,"88a8a062d3fffff",113,252,365
"3009",1970-01-01 11:30:00,"88a8a062d9fffff",171,356,527
"3010",1970-01-01 11:30:00,"88a8a06705fffff",113,252,365
"3011",1970-01-01 11:30:00,"88a8a06707fffff",60,103,163
"3012",1970-01-01 11:30:00,"88a8a0670dfffff",60,103,163
"3013",1970-01-01 11:30:00,"88a8a06731fffff",60,103,163
"3014",1970-01-01 11:30:00,"88a8a06739fffff",60,103,163
"3015",1970-01-01 11:30:00,"88a8a0676bfffff",180,309,489
"3016",1970-01-01 11:30:00,"88a8a06a91fffff",99,234,333
"3017",1970-01-01 11:30:00,"88a8a06a9bfffff",51,150,201
"3018",1970-01-01 11:30:00,"88a8a06ad3fffff",0,0,0
"3019",1970-01-01 11:30:00,"88a8a06adbfffff",0,0,0
"3020",1970-01-01 11:30:00,"88a8a06e49fffff",150,281,431
"3021",1970-01-01 11:30:00,"88a8a06e4dfffff",159,349,508
"3022",1970-01-01 11:30:00,"88a8a06e69fffff",48,96,144
"3023",1970-01-01 11:30:00,"88a8a06e6dfffff",252,581,833
"3024",1970-01-01 11:30:00,"88a8a06f05fffff",99,234,333
"3025",1970-01-01 11:30:00,"88a8a06f63fffff",99,234,333
"3026",1970-01-01 11:30:00,"88a8a06f67fffff",99,234,333
"3027",1970-01-01 11:30:00,"88a8a06f69fffff",96,168,264
"3028",1970-01-01 11:30:00,"88a8a070b3fffff",252,466,718
"3029",1970-01-01 11:30:00,"88a8a070b5fffff",42,82,124
"3030",1970-01-01 11:30:00,"88a8a070b7fffff",210,384,594
"3031",1970-01-01 11:30:00,"88a8a0719bfffff",288,508,796
"3032",1970-01-01 11:30:00,"88a8a07441fffff",383,829,1212
"3033",1970-01-01 11:30:00,"88a8a07445fffff",333,759,1092
"3034",1970-01-01 11:30:00,"88a8a07447fffff",224,505,729
"3035",1970-01-01 11:30:00,"88a8a0744bfffff",395,861,1256
"3036",1970-01-01 11:30:00,"88a8a07461fffff",554,1210,1764
"3037",1970-01-01 11:30:00,"88a8a07465fffff",506,1114,1620
"3038",1970-01-01 11:30:00,"88a8a07467fffff",108,199,307
"3039",1970-01-01 11:30:00,"88a8a07469fffff",60,103,163
"3040",1970-01-01 11:30:00,"88a8a0746bfffff",446,1011,1457
"3041",1970-01-01 11:30:00,"88a8a07503fffff",93,232,325
"3042",1970-01-01 11:30:00,"88a8a07507fffff",317,737,1054
"3043",1970-01-01 11:30:00,"88a8a07515fffff",324,691,1015
"3044",1970-01-01 11:30:00,"88a8a0751dfffff",111,253,364
"3045",1970-01-01 11:30:00,"88a8a07521fffff",477,1026,1503
"3046",1970-01-01 11:30:00,"88a8a07525fffff",315,623,938
"3047",1970-01-01 11:30:00,"88a8a0752bfffff",417,923,1340
"3048",1970-01-01 11:30:00,"88a8a0752dfffff",366,773,1139
"3049",1970-01-01 11:30:00,"88a8a07531fffff",647,1442,2089
"3050",1970-01-01 11:30:00,"88a8a07533fffff",120,206,326
"3051",1970-01-01 11:30:00,"88a8a07535fffff",257,634,891
"3052",1970-01-01 11:30:00,"88a8a07537fffff",171,356,527
"3053",1970-01-01 11:30:00,"88a8a07539fffff",545,1142,1687
"3054",1970-01-01 11:30:00,"88a8a0753bfffff",51,150,201
"3055",1970-01-01 11:30:00,"88a8a0753dfffff",275,655,930
"3056",1970-01-01 11:30:00,"88a8a07543fffff",455,964,1419
"3057",1970-01-01 11:30:00,"88a8a07545fffff",300,515,815
"3058",1970-01-01 11:30:00,"88a8a07547fffff",455,964,1419
"3059",1970-01-01 11:30:00,"88a8a07553fffff",159,349,508
"3060",1970-01-01 11:30:00,"88a8a07557fffff",159,349,508
"3061",1970-01-01 11:30:00,"88a8a07559fffff",515,1067,1582
"3062",1970-01-01 11:30:00,"88a8a0755bfffff",108,199,307
"3063",1970-01-01 11:30:00,"88a8a0755dfffff",515,1067,1582
"3064",1970-01-01 11:30:00,"88a8a07561fffff",495,932,1427
"3065",1970-01-01 11:30:00,"88a8a07565fffff",51,150,201
"3066",1970-01-01 11:30:00,"88a8a07567fffff",486,979,1465
"3067",1970-01-01 11:30:00,"88a8a07569fffff",515,1067,1582
"3068",1970-01-01 11:30:00,"88a8a0756bfffff",284,608,892
"3069",1970-01-01 11:30:00,"88a8a0756dfffff",774,1487,2261
"3070",1970-01-01 11:30:00,"88a8a07633fffff",233,458,691
"3071",1970-01-01 11:30:00,"88a8a07637fffff",395,861,1256
"3072",1970-01-01 11:30:00,"88a8a076c7fffff",53,149,202
"3073",1970-01-01 11:30:00,"88a8a076d1fffff",222,506,728
"3074",1970-01-01 11:30:00,"88a8a076d3fffff",335,758,1093
"3075",1970-01-01 11:30:00,"88a8a076d5fffff",162,403,565
"3076",1970-01-01 11:30:00,"88a8a076e9fffff",212,473,685
"3077",1970-01-01 11:30:00,"88a8a076ebfffff",60,103,163
"3078",1970-01-01 11:30:00,"88a8a076edfffff",161,323,484
"3079",1970-01-01 12:00:00,"88a8a02801fffff",33,60,93
"3080",1970-01-01 12:00:00,"88a8a02805fffff",33,60,93
"3081",1970-01-01 12:00:00,"88a8a02809fffff",0,0,0
"3082",1970-01-01 12:00:00,"88a8a0280bfffff",33,60,93
"3083",1970-01-01 12:00:00,"88a8a02829fffff",33,60,93
"3084",1970-01-01 12:00:00,"88a8a0282dfffff",33,60,93
"3085",1970-01-01 12:00:00,"88a8a02853fffff",33,60,93
"3086",1970-01-01 12:00:00,"88a8a02857fffff",33,60,93
"3087",1970-01-01 12:00:00,"88a8a0291dfffff",33,60,93
"3088",1970-01-01 12:00:00,"88a8a02953fffff",33,60,93
"3089",1970-01-01 12:00:00,"88a8a02957fffff",33,60,93
"3090",1970-01-01 12:00:00,"88a8a02a01fffff",53,149,202
"3091",1970-01-01 12:00:00,"88a8a02a05fffff",152,370,522
"3092",1970-01-01 12:00:00,"88a8a02a0bfffff",51,150,201
"3093",1970-01-01 12:00:00,"88a8a02a0dfffff",53,149,202
"3094",1970-01-01 12:00:00,"88a8a02a11fffff",111,253,364
"3095",1970-01-01 12:00:00,"88a8a02a13fffff",111,253,364
"3096",1970-01-01 12:00:00,"88a8a02a19fffff",111,253,364
"3097",1970-01-01 12:00:00,"88a8a02a57fffff",150,371,521
"3098",1970-01-01 12:00:00,"88a8a02a61fffff",51,150,201
"3099",1970-01-01 12:00:00,"88a8a02a63fffff",152,370,522
"3100",1970-01-01 12:00:00,"88a8a02a69fffff",203,520,723
"3101",1970-01-01 12:00:00,"88a8a02a89fffff",162,403,565
"3102",1970-01-01 12:00:00,"88a8a02a8bfffff",102,300,402
"3103",1970-01-01 12:00:00,"88a8a02a9dfffff",51,150,201
"3104",1970-01-01 12:00:00,"88a8a02ac5fffff",111,253,364
"3105",1970-01-01 12:00:00,"88a8a02ac7fffff",195,463,658
"3106",1970-01-01 12:00:00,"88a8a02ae3fffff",33,60,93
"3107",1970-01-01 12:00:00,"88a8a02ae7fffff",33,60,93
"3108",1970-01-01 12:00:00,"88a8a02aebfffff",33,60,93
"3109",1970-01-01 12:00:00,"88a8a03987fffff",221,426,647
"3110",1970-01-01 12:00:00,"88a8a03995fffff",263,623,886
"3111",1970-01-01 12:00:00,"88a8a03997fffff",203,520,723
"3112",1970-01-01 12:00:00,"88a8a039a1fffff",455,964,1419
"3113",1970-01-01 12:00:00,"88a8a039abfffff",443,932,1375
"3114",1970-01-01 12:00:00,"88a8a039adfffff",399,736,1135
"3115",1970-01-01 12:00:00,"88a8a039b9fffff",427,1025,1452
"3116",1970-01-01 12:00:00,"88a8a039bbfffff",263,623,886
"3117",1970-01-01 12:00:00,"88a8a039bdfffff",51,150,201
"3118",1970-01-01 12:00:00,"88a8a06081fffff",173,355,528
"3119",1970-01-01 12:00:00,"88a8a06085fffff",538,1188,1726
"3120",1970-01-01 12:00:00,"88a8a0608dfffff",629,1421,2050
"3121",1970-01-01 12:00:00,"88a8a060a3fffff",162,403,565
"3122",1970-01-01 12:00:00,"88a8a060a7fffff",51,150,201
"3123",1970-01-01 12:00:00,"88a8a060abfffff",162,403,565
"3124",1970-01-01 12:00:00,"88a8a060c1fffff",102,300,402
"3125",1970-01-01 12:00:00,"88a8a060c3fffff",425,936,1361
"3126",1970-01-01 12:00:00,"88a8a060c7fffff",682,1685,2367
"3127",1970-01-01 12:00:00,"88a8a060cbfffff",476,1086,1562
"3128",1970-01-01 12:00:00,"88a8a06193fffff",213,553,766
"3129",1970-01-01 12:00:00,"88a8a06197fffff",150,384,534
"3130",1970-01-01 12:00:00,"88a8a0619bfffff",111,253,364
"3131",1970-01-01 12:00:00,"88a8a061a1fffff",198,480,678
"3132",1970-01-01 12:00:00,"88a8a061a3fffff",150,384,534
"3133",1970-01-01 12:00:00,"88a8a061a5fffff",249,630,879
"3134",1970-01-01 12:00:00,"88a8a061b1fffff",210,487,697
"3135",1970-01-01 12:00:00,"88a8a061b3fffff",363,937,1300
"3136",1970-01-01 12:00:00,"88a8a061b5fffff",201,534,735
"3137",1970-01-01 12:00:00,"88a8a061b7fffff",411,1021,1432
"3138",1970-01-01 12:00:00,"88a8a06249fffff",336,604,940
"3139",1970-01-01 12:00:00,"88a8a0624bfffff",447,857,1304
"3140",1970-01-01 12:00:00,"88a8a0624dfffff",516,913,1429
"3141",1970-01-01 12:00:00,"88a8a06281fffff",111,253,364
"3142",1970-01-01 12:00:00,"88a8a06283fffff",446,1011,1457
"3143",1970-01-01 12:00:00,"88a8a06287fffff",428,990,1418
"3144",1970-01-01 12:00:00,"88a8a06289fffff",324,691,1015
"3145",1970-01-01 12:00:00,"88a8a0628bfffff",324,691,1015
"3146",1970-01-01 12:00:00,"88a8a06293fffff",111,253,364
"3147",1970-01-01 12:00:00,"88a8a06299fffff",60,103,163
"3148",1970-01-01 12:00:00,"88a8a0629bfffff",111,253,364
"3149",1970-01-01 12:00:00,"88a8a0629dfffff",0,0,0
"3150",1970-01-01 12:00:00,"88a8a062b5fffff",314,683,997
"3151",1970-01-01 12:00:00,"88a8a062bdfffff",428,990,1418
"3152",1970-01-01 12:00:00,"88a8a062c1fffff",60,103,163
"3153",1970-01-01 12:00:00,"88a8a062c3fffff",384,794,1178
"3154",1970-01-01 12:00:00,"88a8a062cbfffff",375,841,1216
"3155",1970-01-01 12:00:00,"88a8a062d1fffff",111,253,364
"3156",1970-01-01 12:00:00,"88a8a062d3fffff",111,253,364
"3157",1970-01-01 12:00:00,"88a8a062d9fffff",120,206,326
"3158",1970-01-01 12:00:00,"88a8a06541fffff",60,103,163
"3159",1970-01-01 12:00:00,"88a8a06549fffff",120,206,326
"3160",1970-01-01 12:00:00,"88a8a06705fffff",51,150,201
"3161",1970-01-01 12:00:00,"88a8a0670dfffff",104,299,403
"3162",1970-01-01 12:00:00,"88a8a06735fffff",60,103,163
"3163",1970-01-01 12:00:00,"88a8a0674dfffff",51,150,201
"3164",1970-01-01 12:00:00,"88a8a0676bfffff",104,299,403
"3165",1970-01-01 12:00:00,"88a8a06a91fffff",51,150,201
"3166",1970-01-01 12:00:00,"88a8a06a9bfffff",51,150,201
"3167",1970-01-01 12:00:00,"88a8a06e49fffff",159,337,496
"3168",1970-01-01 12:00:00,"88a8a06e4dfffff",210,487,697
"3169",1970-01-01 12:00:00,"88a8a06e69fffff",153,450,603
"3170",1970-01-01 12:00:00,"88a8a06e6dfffff",303,834,1137
"3171",1970-01-01 12:00:00,"88a8a06f05fffff",51,150,201
"3172",1970-01-01 12:00:00,"88a8a06f41fffff",0,0,0
"3173",1970-01-01 12:00:00,"88a8a06f4dfffff",0,0,0
"3174",1970-01-01 12:00:00,"88a8a06f59fffff",0,0,0
"3175",1970-01-01 12:00:00,"88a8a06f5dfffff",0,0,0
"3176",1970-01-01 12:00:00,"88a8a06f61fffff",102,300,402
"3177",1970-01-01 12:00:00,"88a8a06f63fffff",102,300,402
"3178",1970-01-01 12:00:00,"88a8a06f67fffff",102,300,402
"3179",1970-01-01 12:00:00,"88a8a06f69fffff",153,450,603
"3180",1970-01-01 12:00:00,"88a8a070b3fffff",399,761,1160
"3181",1970-01-01 12:00:00,"88a8a070b7fffff",507,960,1467
"3182",1970-01-01 12:00:00,"88a8a0719bfffff",288,508,796
"3183",1970-01-01 12:00:00,"88a8a07441fffff",499,1160,1659
"3184",1970-01-01 12:00:00,"88a8a07445fffff",397,860,1257
"3185",1970-01-01 12:00:00,"88a8a07447fffff",328,804,1132
"3186",1970-01-01 12:00:00,"88a8a0744bfffff",448,1010,1458
"3187",1970-01-01 12:00:00,"88a8a07461fffff",763,1748,2511
"3188",1970-01-01 12:00:00,"88a8a07465fffff",446,1011,1457
"3189",1970-01-01 12:00:00,"88a8a07467fffff",153,335,488
"3190",1970-01-01 12:00:00,"88a8a07469fffff",153,335,488
"3191",1970-01-01 12:00:00,"88a8a0746bfffff",592,1392,1984
"3192",1970-01-01 12:00:00,"88a8a07507fffff",273,656,929
"3193",1970-01-01 12:00:00,"88a8a07515fffff",171,356,527
"3194",1970-01-01 12:00:00,"88a8a0751dfffff",102,185,287
"3195",1970-01-01 12:00:00,"88a8a07521fffff",342,712,1054
"3196",1970-01-01 12:00:00,"88a8a07525fffff",291,562,853
"3197",1970-01-01 12:00:00,"88a8a0752bfffff",342,712,1054
"3198",1970-01-01 12:00:00,"88a8a0752dfffff",402,815,1217
"3199",1970-01-01 12:00:00,"88a8a07531fffff",564,1103,1667
"3200",1970-01-01 12:00:00,"88a8a07533fffff",60,103,163
"3201",1970-01-01 12:00:00,"88a8a07535fffff",375,841,1216
"3202",1970-01-01 12:00:00,"88a8a07537fffff",120,206,326
"3203",1970-01-01 12:00:00,"88a8a07539fffff",555,1150,1705
"3204",1970-01-01 12:00:00,"88a8a0753bfffff",60,103,163
"3205",1970-01-01 12:00:00,"88a8a0753dfffff",222,506,728
"3206",1970-01-01 12:00:00,"88a8a07543fffff",379,954,1333
"3207",1970-01-01 12:00:00,"88a8a07545fffff",275,655,930
"3208",1970-01-01 12:00:00,"88a8a07547fffff",439,1057,1496
"3209",1970-01-01 12:00:00,"88a8a07557fffff",60,103,163
"3210",1970-01-01 12:00:00,"88a8a07559fffff",439,1057,1496
"3211",1970-01-01 12:00:00,"88a8a0755bfffff",111,253,364
"3212",1970-01-01 12:00:00,"88a8a0755dfffff",439,1057,1496
"3213",1970-01-01 12:00:00,"88a8a07561fffff",402,815,1217
"3214",1970-01-01 12:00:00,"88a8a07565fffff",60,103,163
"3215",1970-01-01 12:00:00,"88a8a07567fffff",402,815,1217
"3216",1970-01-01 12:00:00,"88a8a07569fffff",337,757,1094
"3217",1970-01-01 12:00:00,"88a8a0756bfffff",386,908,1294
"3218",1970-01-01 12:00:00,"88a8a0756dfffff",678,1457,2135
"3219",1970-01-01 12:00:00,"88a8a07633fffff",439,1057,1496
"3220",1970-01-01 12:00:00,"88a8a07637fffff",395,861,1256
"3221",1970-01-01 12:00:00,"88a8a076c7fffff",162,403,565
"3222",1970-01-01 12:00:00,"88a8a076d1fffff",339,633,972
"3223",1970-01-01 12:00:00,"88a8a076d3fffff",503,1035,1538
"3224",1970-01-01 12:00:00,"88a8a076d5fffff",279,530,809
"3225",1970-01-01 12:00:00,"88a8a076d7fffff",224,505,729
"3226",1970-01-01 12:00:00,"88a8a076e9fffff",328,804,1132
"3227",1970-01-01 12:00:00,"88a8a076ebfffff",268,701,969
"3228",1970-01-01 12:00:00,"88a8a076edfffff",388,907,1295
"3229",1970-01-01 12:30:00,"88a8a02801fffff",33,60,93
"3230",1970-01-01 12:30:00,"88a8a02805fffff",33,60,93
"3231",1970-01-01 12:30:00,"88a8a02809fffff",0,0,0
"3232",1970-01-01 12:30:00,"88a8a0280bfffff",33,60,93
"3233",1970-01-01 12:30:00,"88a8a02825fffff",33,60,93
"3234",1970-01-01 12:30:00,"88a8a02829fffff",33,60,93
"3235",1970-01-01 12:30:00,"88a8a0282dfffff",33,60,93
"3236",1970-01-01 12:30:00,"88a8a02857fffff",33,60,93
"3237",1970-01-01 12:30:00,"88a8a02903fffff",0,0,0
"3238",1970-01-01 12:30:00,"88a8a02907fffff",0,0,0
"3239",1970-01-01 12:30:00,"88a8a0290bfffff",0,0,0
"3240",1970-01-01 12:30:00,"88a8a02919fffff",33,60,93
"3241",1970-01-01 12:30:00,"88a8a02923fffff",0,0,0
"3242",1970-01-01 12:30:00,"88a8a02927fffff",0,0,0
"3243",1970-01-01 12:30:00,"88a8a0292bfffff",0,0,0
"3244",1970-01-01 12:30:00,"88a8a02953fffff",0,0,0
"3245",1970-01-01 12:30:00,"88a8a02957fffff",0,0,0
"3246",1970-01-01 12:30:00,"88a8a02a01fffff",51,150,201
"3247",1970-01-01 12:30:00,"88a8a02a05fffff",153,450,603
"3248",1970-01-01 12:30:00,"88a8a02a0dfffff",104,299,403
"3249",1970-01-01 12:30:00,"88a8a02a11fffff",51,150,201
"3250",1970-01-01 12:30:00,"88a8a02a13fffff",104,299,403
"3251",1970-01-01 12:30:00,"88a8a02a19fffff",51,150,201
"3252",1970-01-01 12:30:00,"88a8a02a57fffff",0,0,0
"3253",1970-01-01 12:30:00,"88a8a02a61fffff",51,150,201
"3254",1970-01-01 12:30:00,"88a8a02a63fffff",157,448,605
"3255",1970-01-01 12:30:00,"88a8a02a69fffff",106,298,404
"3256",1970-01-01 12:30:00,"88a8a02a6bfffff",104,299,403
"3257",1970-01-01 12:30:00,"88a8a02a6dfffff",51,150,201
"3258",1970-01-01 12:30:00,"88a8a02a89fffff",51,150,201
"3259",1970-01-01 12:30:00,"88a8a02a8bfffff",51,150,201
"3260",1970-01-01 12:30:00,"88a8a02a9dfffff",51,150,201
"3261",1970-01-01 12:30:00,"88a8a02ac5fffff",104,299,403
"3262",1970-01-01 12:30:00,"88a8a02ac7fffff",51,150,201
"3263",1970-01-01 12:30:00,"88a8a03987fffff",51,150,201
"3264",1970-01-01 12:30:00,"88a8a03995fffff",60,103,163
"3265",1970-01-01 12:30:00,"88a8a03997fffff",154,369,523
"3266",1970-01-01 12:30:00,"88a8a039a1fffff",275,655,930
"3267",1970-01-01 12:30:00,"88a8a039abfffff",215,552,767
"3268",1970-01-01 12:30:00,"88a8a039adfffff",430,1104,1534
"3269",1970-01-01 12:30:00,"88a8a039b9fffff",212,473,685
"3270",1970-01-01 12:30:00,"88a8a039bbfffff",376,875,1251
"3271",1970-01-01 12:30:00,"88a8a039bdfffff",113,252,365
"3272",1970-01-01 12:30:00,"88a8a06085fffff",420,974,1394
"3273",1970-01-01 12:30:00,"88a8a0608dfffff",300,665,965
"3274",1970-01-01 12:30:00,"88a8a060a3fffff",261,637,898
"3275",1970-01-01 12:30:00,"88a8a060abfffff",159,337,496
"3276",1970-01-01 12:30:00,"88a8a060c1fffff",60,103,163
"3277",1970-01-01 12:30:00,"88a8a060c3fffff",153,335,488
"3278",1970-01-01 12:30:00,"88a8a060c7fffff",153,335,488
"3279",1970-01-01 12:30:00,"88a8a060cbfffff",294,663,957
"3280",1970-01-01 12:30:00,"88a8a06193fffff",162,403,565
"3281",1970-01-01 12:30:00,"88a8a06197fffff",213,553,766
"3282",1970-01-01 12:30:00,"88a8a061a1fffff",51,150,201
"3283",1970-01-01 12:30:00,"88a8a061a3fffff",51,150,201
"3284",1970-01-01 12:30:00,"88a8a061a5fffff",51,150,201
"3285",1970-01-01 12:30:00,"88a8a061b1fffff",213,553,766
"3286",1970-01-01 12:30:00,"88a8a061b3fffff",162,403,565
"3287",1970-01-01 12:30:00,"88a8a061b5fffff",51,150,201
"3288",1970-01-01 12:30:00,"88a8a061b7fffff",213,553,766
"3289",1970-01-01 12:30:00,"88a8a061e7fffff",0,0,0
"3290",1970-01-01 12:30:00,"88a8a06249fffff",162,403,565
"3291",1970-01-01 12:30:00,"88a8a0624bfffff",164,402,566
"3292",1970-01-01 12:30:00,"88a8a0624dfffff",282,609,891
"3293",1970-01-01 12:30:00,"88a8a06281fffff",53,149,202
"3294",1970-01-01 12:30:00,"88a8a06283fffff",297,717,1014
"3295",1970-01-01 12:30:00,"88a8a06287fffff",315,738,1053
"3296",1970-01-01 12:30:00,"88a8a06289fffff",308,669,977
"3297",1970-01-01 12:30:00,"88a8a0628bfffff",60,103,163
"3298",1970-01-01 12:30:00,"88a8a06293fffff",0,0,0
"3299",1970-01-01 12:30:00,"88a8a06299fffff",120,206,326
"3300",1970-01-01 12:30:00,"88a8a0629bfffff",60,103,163
"3301",1970-01-01 12:30:00,"88a8a062b5fffff",186,464,650
"3302",1970-01-01 12:30:00,"88a8a062bdfffff",315,738,1053
"3303",1970-01-01 12:30:00,"88a8a062c1fffff",204,370,574
"3304",1970-01-01 12:30:00,"88a8a062c3fffff",266,587,853
"3305",1970-01-01 12:30:00,"88a8a062cbfffff",266,587,853
"3306",1970-01-01 12:30:00,"88a8a062d1fffff",171,356,527
"3307",1970-01-01 12:30:00,"88a8a062d3fffff",120,206,326
"3308",1970-01-01 12:30:00,"88a8a062d5fffff",0,0,0
"3309",1970-01-01 12:30:00,"88a8a062d7fffff",0,0,0
"3310",1970-01-01 12:30:00,"88a8a062d9fffff",111,253,364
"3311",1970-01-01 12:30:00,"88a8a0634dfffff",0,0,0
"3312",1970-01-01 12:30:00,"88a8a06611fffff",0,0,0
"3313",1970-01-01 12:30:00,"88a8a06613fffff",0,0,0
"3314",1970-01-01 12:30:00,"88a8a06615fffff",0,0,0
"3315",1970-01-01 12:30:00,"88a8a06623fffff",0,0,0
"3316",1970-01-01 12:30:00,"88a8a06627fffff",0,0,0
"3317",1970-01-01 12:30:00,"88a8a06639fffff",0,0,0
"3318",1970-01-01 12:30:00,"88a8a0663dfffff",0,0,0
"3319",1970-01-01 12:30:00,"88a8a066cdfffff",0,0,0
"3320",1970-01-01 12:30:00,"88a8a06705fffff",180,309,489
"3321",1970-01-01 12:30:00,"88a8a06707fffff",60,103,163
"3322",1970-01-01 12:30:00,"88a8a0670dfffff",120,206,326
"3323",1970-01-01 12:30:00,"88a8a06719fffff",0,0,0
"3324",1970-01-01 12:30:00,"88a8a0671bfffff",0,0,0
"3325",1970-01-01 12:30:00,"88a8a06739fffff",60,103,163
"3326",1970-01-01 12:30:00,"88a8a0673dfffff",60,103,163
"3327",1970-01-01 12:30:00,"88a8a0676bfffff",120,206,326
"3328",1970-01-01 12:30:00,"88a8a06a91fffff",102,300,402
"3329",1970-01-01 12:30:00,"88a8a06a9bfffff",51,150,201
"3330",1970-01-01 12:30:00,"88a8a06ad3fffff",0,0,0
"3331",1970-01-01 12:30:00,"88a8a06adbfffff",0,0,0
"3332",1970-01-01 12:30:00,"88a8a06e49fffff",213,553,766
"3333",1970-01-01 12:30:00,"88a8a06e4dfffff",264,703,967
"3334",1970-01-01 12:30:00,"88a8a06e6dfffff",213,553,766
"3335",1970-01-01 12:30:00,"88a8a06f05fffff",51,150,201
"3336",1970-01-01 12:30:00,"88a8a06f4bfffff",0,0,0
"3337",1970-01-01 12:30:00,"88a8a06f4dfffff",0,0,0
"3338",1970-01-01 12:30:00,"88a8a06f5dfffff",0,0,0
"3339",1970-01-01 12:30:00,"88a8a06f63fffff",51,150,201
"3340",1970-01-01 12:30:00,"88a8a06f67fffff",51,150,201
"3341",1970-01-01 12:30:00,"88a8a06f69fffff",51,150,201
"3342",1970-01-01 12:30:00,"88a8a07097fffff",0,0,0
"3343",1970-01-01 12:30:00,"88a8a070a3fffff",0,0,0
"3344",1970-01-01 12:30:00,"88a8a070a7fffff",0,0,0
"3345",1970-01-01 12:30:00,"88a8a070b3fffff",224,505,729
"3346",1970-01-01 12:30:00,"88a8a070b7fffff",217,551,768
"3347",1970-01-01 12:30:00,"88a8a070bbfffff",0,0,0
"3348",1970-01-01 12:30:00,"88a8a07183fffff",0,0,0
"3349",1970-01-01 12:30:00,"88a8a07191fffff",0,0,0
"3350",1970-01-01 12:30:00,"88a8a07193fffff",60,103,163
"3351",1970-01-01 12:30:00,"88a8a07199fffff",0,0,0
"3352",1970-01-01 12:30:00,"88a8a0719bfffff",284,608,892
"3353",1970-01-01 12:30:00,"88a8a0719dfffff",0,0,0
"3354",1970-01-01 12:30:00,"88a8a071bdfffff",0,0,0
"3355",1970-01-01 12:30:00,"88a8a07441fffff",258,545,803
"3356",1970-01-01 12:30:00,"88a8a07445fffff",108,174,282
"3357",1970-01-01 12:30:00,"88a8a07447fffff",162,403,565
"3358",1970-01-01 12:30:00,"88a8a0744bfffff",162,403,565
"3359",1970-01-01 12:30:00,"88a8a07461fffff",210,474,684
"3360",1970-01-01 12:30:00,"88a8a07465fffff",270,577,847
"3361",1970-01-01 12:30:00,"88a8a07467fffff",51,150,201
"3362",1970-01-01 12:30:00,"88a8a07469fffff",51,150,201
"3363",1970-01-01 12:30:00,"88a8a0746bfffff",99,221,320
"3364",1970-01-01 12:30:00,"88a8a07507fffff",162,288,450
"3365",1970-01-01 12:30:00,"88a8a07515fffff",162,403,565
"3366",1970-01-01 12:30:00,"88a8a0751dfffff",111,253,364
"3367",1970-01-01 12:30:00,"88a8a07521fffff",395,746,1141
"3368",1970-01-01 12:30:00,"88a8a07525fffff",233,458,691
"3369",1970-01-01 12:30:00,"88a8a0752bfffff",342,597,939
"3370",1970-01-01 12:30:00,"88a8a0752dfffff",326,690,1016
"3371",1970-01-01 12:30:00,"88a8a07531fffff",548,1196,1744
"3372",1970-01-01 12:30:00,"88a8a07533fffff",51,150,201
"3373",1970-01-01 12:30:00,"88a8a07535fffff",368,772,1140
"3374",1970-01-01 12:30:00,"88a8a07537fffff",111,253,364
"3375",1970-01-01 12:30:00,"88a8a07539fffff",437,943,1380
"3376",1970-01-01 12:30:00,"88a8a0753bfffff",51,150,201
"3377",1970-01-01 12:30:00,"88a8a0753dfffff",231,459,690
"3378",1970-01-01 12:30:00,"88a8a07543fffff",339,633,972
"3379",1970-01-01 12:30:00,"88a8a07545fffff",111,253,364
"3380",1970-01-01 12:30:00,"88a8a07547fffff",339,633,972
"3381",1970-01-01 12:30:00,"88a8a07553fffff",51,150,201
"3382",1970-01-01 12:30:00,"88a8a07557fffff",111,253,364
"3383",1970-01-01 12:30:00,"88a8a07559fffff",330,680,1010
"3384",1970-01-01 12:30:00,"88a8a0755bfffff",51,150,201
"3385",1970-01-01 12:30:00,"88a8a0755dfffff",339,633,972
"3386",1970-01-01 12:30:00,"88a8a07561fffff",488,978,1466
"3387",1970-01-01 12:30:00,"88a8a07567fffff",386,793,1179
"3388",1970-01-01 12:30:00,"88a8a07569fffff",210,474,684
"3389",1970-01-01 12:30:00,"88a8a0756bfffff",219,427,646
"3390",1970-01-01 12:30:00,"88a8a0756dfffff",547,1231,1778
"3391",1970-01-01 12:30:00,"88a8a07633fffff",330,680,1010
"3392",1970-01-01 12:30:00,"88a8a07637fffff",162,403,565
"3393",1970-01-01 12:30:00,"88a8a076c7fffff",111,253,364
"3394",1970-01-01 12:30:00,"88a8a076d1fffff",162,403,565
"3395",1970-01-01 12:30:00,"88a8a076d3fffff",379,954,1333
"3396",1970-01-01 12:30:00,"88a8a076d5fffff",113,252,365
"3397",1970-01-01 12:30:00,"88a8a076d7fffff",215,552,767
"3398",1970-01-01 12:30:00,"88a8a076e9fffff",162,403,565
"3399",1970-01-01 12:30:00,"88a8a076ebfffff",102,300,402
"3400",1970-01-01 12:30:00,"88a8a076edfffff",162,403,565
"3401",1970-01-01 12:30:00,"88a8a07a93fffff",0,0,0
"3402",1970-01-01 12:30:00,"88a8a07ab3fffff",0,0,0
"3403",1970-01-01 13:00:00,"88a8a02809fffff",0,0,0
"3404",1970-01-01 13:00:00,"88a8a02a01fffff",153,450,603
"3405",1970-01-01 13:00:00,"88a8a02a05fffff",102,300,402
"3406",1970-01-01 13:00:00,"88a8a02a0bfffff",51,150,201
"3407",1970-01-01 13:00:00,"88a8a02a11fffff",51,150,201
"3408",1970-01-01 13:00:00,"88a8a02a13fffff",155,449,604
"3409",1970-01-01 13:00:00,"88a8a02a63fffff",102,300,402
"3410",1970-01-01 13:00:00,"88a8a02a69fffff",102,300,402
"3411",1970-01-01 13:00:00,"88a8a02a6bfffff",51,150,201
"3412",1970-01-01 13:00:00,"88a8a02a89fffff",155,449,604
"3413",1970-01-01 13:00:00,"88a8a02a8bfffff",155,449,604
"3414",1970-01-01 13:00:00,"88a8a02a9dfffff",53,149,202
"3415",1970-01-01 13:00:00,"88a8a02ac5fffff",155,449,604
"3416",1970-01-01 13:00:00,"88a8a02ac7fffff",155,449,604
"3417",1970-01-01 13:00:00,"88a8a03987fffff",51,150,201
"3418",1970-01-01 13:00:00,"88a8a03997fffff",102,300,402
"3419",1970-01-01 13:00:00,"88a8a039a1fffff",111,253,364
"3420",1970-01-01 13:00:00,"88a8a039abfffff",111,253,364
"3421",1970-01-01 13:00:00,"88a8a039adfffff",60,103,163
"3422",1970-01-01 13:00:00,"88a8a039b9fffff",102,300,402
"3423",1970-01-01 13:00:00,"88a8a039bbfffff",102,300,402
"3424",1970-01-01 13:00:00,"88a8a039bdfffff",102,300,402
"3425",1970-01-01 13:00:00,"88a8a06081fffff",51,150,201
"3426",1970-01-01 13:00:00,"88a8a06085fffff",204,485,689
"3427",1970-01-01 13:00:00,"88a8a0608dfffff",213,438,651
"3428",1970-01-01 13:00:00,"88a8a060a3fffff",150,384,534
"3429",1970-01-01 13:00:00,"88a8a060abfffff",102,300,402
"3430",1970-01-01 13:00:00,"88a8a060c3fffff",264,473,737
"3431",1970-01-01 13:00:00,"88a8a060c7fffff",204,370,574
"3432",1970-01-01 13:00:00,"88a8a060cbfffff",222,391,613
"3433",1970-01-01 13:00:00,"88a8a06193fffff",210,487,697
"3434",1970-01-01 13:00:00,"88a8a06197fffff",159,337,496
"3435",1970-01-01 13:00:00,"88a8a061a1fffff",99,234,333
"3436",1970-01-01 13:00:00,"88a8a061a3fffff",99,234,333
"3437",1970-01-01 13:00:00,"88a8a061a5fffff",99,234,333
"3438",1970-01-01 13:00:00,"88a8a061b1fffff",60,103,163
"3439",1970-01-01 13:00:00,"88a8a061b3fffff",159,337,496
"3440",1970-01-01 13:00:00,"88a8a061b5fffff",99,234,333
"3441",1970-01-01 13:00:00,"88a8a061b7fffff",99,234,333
"3442",1970-01-01 13:00:00,"88a8a06249fffff",162,403,565
"3443",1970-01-01 13:00:00,"88a8a0624bfffff",162,403,565
"3444",1970-01-01 13:00:00,"88a8a0624dfffff",153,450,603
"3445",1970-01-01 13:00:00,"88a8a06281fffff",60,103,163
"3446",1970-01-01 13:00:00,"88a8a06283fffff",222,391,613
"3447",1970-01-01 13:00:00,"88a8a06287fffff",273,541,814
"3448",1970-01-01 13:00:00,"88a8a06289fffff",102,185,287
"3449",1970-01-01 13:00:00,"88a8a0628bfffff",153,335,488
"3450",1970-01-01 13:00:00,"88a8a06299fffff",60,103,163
"3451",1970-01-01 13:00:00,"88a8a062b5fffff",222,391,613
"3452",1970-01-01 13:00:00,"88a8a062b9fffff",0,0,0
"3453",1970-01-01 13:00:00,"88a8a062bdfffff",273,541,814
"3454",1970-01-01 13:00:00,"88a8a062c3fffff",102,185,287
"3455",1970-01-01 13:00:00,"88a8a062cbfffff",102,185,287
"3456",1970-01-01 13:00:00,"88a8a062d1fffff",60,103,163
"3457",1970-01-01 13:00:00,"88a8a062d3fffff",60,103,163
"3458",1970-01-01 13:00:00,"88a8a062d7fffff",0,0,0
"3459",1970-01-01 13:00:00,"88a8a062d9fffff",60,103,163
"3460",1970-01-01 13:00:00,"88a8a06701fffff",0,0,0
"3461",1970-01-01 13:00:00,"88a8a06703fffff",0,0,0
"3462",1970-01-01 13:00:00,"88a8a06705fffff",0,0,0
"3463",1970-01-01 13:00:00,"88a8a06707fffff",0,0,0
"3464",1970-01-01 13:00:00,"88a8a0671dfffff",0,0,0
"3465",1970-01-01 13:00:00,"88a8a0672bfffff",0,0,0
"3466",1970-01-01 13:00:00,"88a8a06739fffff",0,0,0
"3467",1970-01-01 13:00:00,"88a8a06a9bfffff",99,234,333
"3468",1970-01-01 13:00:00,"88a8a06e49fffff",150,384,534
"3469",1970-01-01 13:00:00,"88a8a06e4dfffff",210,487,697
"3470",1970-01-01 13:00:00,"88a8a06e6dfffff",159,337,496
"3471",1970-01-01 13:00:00,"88a8a070b3fffff",277,654,931
"3472",1970-01-01 13:00:00,"88a8a070b7fffff",164,402,566
"3473",1970-01-01 13:00:00,"88a8a0719bfffff",153,450,603
"3474",1970-01-01 13:00:00,"88a8a07441fffff",231,459,690
"3475",1970-01-01 13:00:00,"88a8a07445fffff",111,253,364
"3476",1970-01-01 13:00:00,"88a8a0744bfffff",171,356,527
"3477",1970-01-01 13:00:00,"88a8a07461fffff",222,506,728
"3478",1970-01-01 13:00:00,"88a8a07465fffff",213,553,766
"3479",1970-01-01 13:00:00,"88a8a07467fffff",120,206,326
"3480",1970-01-01 13:00:00,"88a8a07469fffff",60,103,163
"3481",1970-01-01 13:00:00,"88a8a0746bfffff",159,324,483
"3482",1970-01-01 13:00:00,"88a8a07507fffff",291,562,853
"3483",1970-01-01 13:00:00,"88a8a07515fffff",222,391,613
"3484",1970-01-01 13:00:00,"88a8a0751dfffff",102,185,287
"3485",1970-01-01 13:00:00,"88a8a07521fffff",453,965,1418
"3486",1970-01-01 13:00:00,"88a8a07525fffff",402,815,1217
"3487",1970-01-01 13:00:00,"88a8a0752bfffff",402,815,1217
"3488",1970-01-01 13:00:00,"88a8a0752dfffff",453,965,1418
"3489",1970-01-01 13:00:00,"88a8a07531fffff",384,794,1178
"3490",1970-01-01 13:00:00,"88a8a07533fffff",60,103,163
"3491",1970-01-01 13:00:00,"88a8a07535fffff",153,335,488
"3492",1970-01-01 13:00:00,"88a8a07537fffff",120,206,326
"3493",1970-01-01 13:00:00,"88a8a07539fffff",513,953,1466
"3494",1970-01-01 13:00:00,"88a8a0753bfffff",102,185,287
"3495",1970-01-01 13:00:00,"88a8a0753dfffff",162,403,565
"3496",1970-01-01 13:00:00,"88a8a07543fffff",102,300,402
"3497",1970-01-01 13:00:00,"88a8a07545fffff",60,103,163
"3498",1970-01-01 13:00:00,"88a8a07547fffff",102,300,402
"3499",1970-01-01 13:00:00,"88a8a07553fffff",60,103,163
"3500",1970-01-01 13:00:00,"88a8a07557fffff",60,103,163
"3501",1970-01-01 13:00:00,"88a8a07559fffff",102,300,402
"3502",1970-01-01 13:00:00,"88a8a0755bfffff",60,103,163
"3503",1970-01-01 13:00:00,"88a8a0755dfffff",102,300,402
"3504",1970-01-01 13:00:00,"88a8a07561fffff",342,712,1054
"3505",1970-01-01 13:00:00,"88a8a07567fffff",282,609,891
"3506",1970-01-01 13:00:00,"88a8a07569fffff",111,253,364
"3507",1970-01-01 13:00:00,"88a8a0756bfffff",111,253,364
"3508",1970-01-01 13:00:00,"88a8a0756dfffff",446,1011,1457
"3509",1970-01-01 13:00:00,"88a8a07633fffff",60,103,163
"3510",1970-01-01 13:00:00,"88a8a07637fffff",171,356,527
"3511",1970-01-01 13:00:00,"88a8a076c7fffff",60,103,163
"3512",1970-01-01 13:00:00,"88a8a076d1fffff",60,103,163
"3513",1970-01-01 13:00:00,"88a8a076d3fffff",60,103,163
"3514",1970-01-01 13:00:00,"88a8a076d5fffff",51,150,201
"3515",1970-01-01 13:00:00,"88a8a076d7fffff",60,103,163
"3516",1970-01-01 13:00:00,"88a8a076e9fffff",60,103,163
"3517",1970-01-01 13:00:00,"88a8a076ebfffff",60,103,163
"3518",1970-01-01 13:00:00,"88a8a076edfffff",113,252,365
"3519",1970-01-01 13:00:00,"88a8a078c1fffff",0,0,0
"3520",1970-01-01 13:00:00,"88a8a078c5fffff",0,0,0
"3521",1970-01-01 13:00:00,"88a8a078cbfffff",0,0,0
"3522",1970-01-01 13:00:00,"88a8a078d9fffff",0,0,0
"3523",1970-01-01 13:00:00,"88a8a07ab7fffff",0,0,0
"3524",1970-01-01 13:30:00,"88a8a02809fffff",0,0,0
"3525",1970-01-01 13:30:00,"88a8a02829fffff",33,60,93
"3526",1970-01-01 13:30:00,"88a8a0282dfffff",33,60,93
"3527",1970-01-01 13:30:00,"88a8a02a01fffff",51,150,201
"3528",1970-01-01 13:30:00,"88a8a02a05fffff",51,150,201
"3529",1970-01-01 13:30:00,"88a8a02a0bfffff",51,150,201
"3530",1970-01-01 13:30:00,"88a8a02a11fffff",104,299,403
"3531",1970-01-01 13:30:00,"88a8a02a19fffff",104,299,403
"3532",1970-01-01 13:30:00,"88a8a02a57fffff",53,149,202
"3533",1970-01-01 13:30:00,"88a8a02a61fffff",51,150,201
"3534",1970-01-01 13:30:00,"88a8a02a63fffff",51,150,201
"3535",1970-01-01 13:30:00,"88a8a02a69fffff",104,299,403
"3536",1970-01-01 13:30:00,"88a8a02a9dfffff",51,150,201
"3537",1970-01-01 13:30:00,"88a8a03987fffff",173,355,528
"3538",1970-01-01 13:30:00,"88a8a03995fffff",284,608,892
"3539",1970-01-01 13:30:00,"88a8a03997fffff",53,149,202
"3540",1970-01-01 13:30:00,"88a8a039a1fffff",104,299,403
"3541",1970-01-01 13:30:00,"88a8a039abfffff",266,702,968
"3542",1970-01-01 13:30:00,"88a8a039adfffff",266,702,968
"3543",1970-01-01 13:30:00,"88a8a039b9fffff",155,449,604
"3544",1970-01-01 13:30:00,"88a8a039bbfffff",275,655,930
"3545",1970-01-01 13:30:00,"88a8a06085fffff",222,506,728
"3546",1970-01-01 13:30:00,"88a8a0608dfffff",171,356,527
"3547",1970-01-01 13:30:00,"88a8a060a3fffff",60,103,163
"3548",1970-01-01 13:30:00,"88a8a060abfffff",171,356,527
"3549",1970-01-01 13:30:00,"88a8a060c3fffff",93,232,325
"3550",1970-01-01 13:30:00,"88a8a060c7fffff",111,253,364
"3551",1970-01-01 13:30:00,"88a8a060cbfffff",195,417,612
"3552",1970-01-01 13:30:00,"88a8a06193fffff",111,253,364
"3553",1970-01-01 13:30:00,"88a8a06197fffff",111,253,364
"3554",1970-01-01 13:30:00,"88a8a0619bfffff",60,103,163
"3555",1970-01-01 13:30:00,"88a8a061a1fffff",51,150,201
"3556",1970-01-01 13:30:00,"88a8a061a3fffff",51,150,201
"3557",1970-01-01 13:30:00,"88a8a061a5fffff",51,150,201
"3558",1970-01-01 13:30:00,"88a8a061b1fffff",42,82,124
"3559",1970-01-01 13:30:00,"88a8a061b3fffff",111,253,364
"3560",1970-01-01 13:30:00,"88a8a061b5fffff",51,150,201
"3561",1970-01-01 13:30:00,"88a8a061b7fffff",153,335,488
"3562",1970-01-01 13:30:00,"88a8a06249fffff",180,309,489
"3563",1970-01-01 13:30:00,"88a8a0624bfffff",120,206,326
"3564",1970-01-01 13:30:00,"88a8a0624dfffff",180,309,489
"3565",1970-01-01 13:30:00,"88a8a06281fffff",51,150,201
"3566",1970-01-01 13:30:00,"88a8a06283fffff",144,382,526
"3567",1970-01-01 13:30:00,"88a8a06287fffff",153,335,488
"3568",1970-01-01 13:30:00,"88a8a06289fffff",195,532,727
"3569",1970-01-01 13:30:00,"88a8a0628bfffff",93,232,325
"3570",1970-01-01 13:30:00,"88a8a06293fffff",120,206,326
"3571",1970-01-01 13:30:00,"88a8a06299fffff",120,206,326
"3572",1970-01-01 13:30:00,"88a8a0629bfffff",120,206,326
"3573",1970-01-01 13:30:00,"88a8a062b5fffff",153,335,488
"3574",1970-01-01 13:30:00,"88a8a062bdfffff",195,417,612
"3575",1970-01-01 13:30:00,"88a8a062c1fffff",195,532,727
"3576",1970-01-01 13:30:00,"88a8a062c3fffff",153,450,603
"3577",1970-01-01 13:30:00,"88a8a062cbfffff",246,682,928
"3578",1970-01-01 13:30:00,"88a8a062d1fffff",120,206,326
"3579",1970-01-01 13:30:00,"88a8a062d3fffff",60,103,163
"3580",1970-01-01 13:30:00,"88a8a062d9fffff",180,309,489
"3581",1970-01-01 13:30:00,"88a8a0634dfffff",0,0,0
"3582",1970-01-01 13:30:00,"88a8a06541fffff",60,103,163
"3583",1970-01-01 13:30:00,"88a8a06549fffff",120,206,326
"3584",1970-01-01 13:30:00,"88a8a06705fffff",60,103,163
"3585",1970-01-01 13:30:00,"88a8a06707fffff",0,0,0
"3586",1970-01-01 13:30:00,"88a8a0670dfffff",0,0,0
"3587",1970-01-01 13:30:00,"88a8a06731fffff",0,0,0
"3588",1970-01-01 13:30:00,"88a8a06735fffff",120,206,326
"3589",1970-01-01 13:30:00,"88a8a06739fffff",0,0,0
"3590",1970-01-01 13:30:00,"88a8a0674dfffff",60,103,163
"3591",1970-01-01 13:30:00,"88a8a0676bfffff",60,103,163
"3592",1970-01-01 13:30:00,"88a8a06a91fffff",48,84,132
"3593",1970-01-01 13:30:00,"88a8a06a9bfffff",0,0,0
"3594",1970-01-01 13:30:00,"88a8a06e49fffff",111,253,364
"3595",1970-01-01 13:30:00,"88a8a06e4dfffff",102,300,402
"3596",1970-01-01 13:30:00,"88a8a06e69fffff",0,0,0
"3597",1970-01-01 13:30:00,"88a8a06e6dfffff",111,253,364
"3598",1970-01-01 13:30:00,"88a8a06f05fffff",48,84,132
"3599",1970-01-01 13:30:00,"88a8a06f41fffff",0,0,0
"3600",1970-01-01 13:30:00,"88a8a06f4dfffff",0,0,0
"3601",1970-01-01 13:30:00,"88a8a06f59fffff",0,0,0
"3602",1970-01-01 13:30:00,"88a8a06f5dfffff",0,0,0
"3603",1970-01-01 13:30:00,"88a8a06f61fffff",96,168,264
"3604",1970-01-01 13:30:00,"88a8a06f63fffff",96,168,264
"3605",1970-01-01 13:30:00,"88a8a06f67fffff",48,84,132
"3606",1970-01-01 13:30:00,"88a8a06f69fffff",96,168,264
"3607",1970-01-01 13:30:00,"88a8a070b7fffff",60,103,163
"3608",1970-01-01 13:30:00,"88a8a07191fffff",0,0,0
"3609",1970-01-01 13:30:00,"88a8a0719bfffff",120,206,326
"3610",1970-01-01 13:30:00,"88a8a0719dfffff",0,0,0
"3611",1970-01-01 13:30:00,"88a8a071b5fffff",0,0,0
"3612",1970-01-01 13:30:00,"88a8a071b9fffff",0,0,0
"3613",1970-01-01 13:30:00,"88a8a071bdfffff",0,0,0
"3614",1970-01-01 13:30:00,"88a8a07441fffff",162,403,565
"3615",1970-01-01 13:30:00,"88a8a07445fffff",60,103,163
"3616",1970-01-01 13:30:00,"88a8a07447fffff",102,300,402
"3617",1970-01-01 13:30:00,"88a8a0744bfffff",111,253,364
"3618",1970-01-01 13:30:00,"88a8a07461fffff",381,715,1096
"3619",1970-01-01 13:30:00,"88a8a07465fffff",282,609,891
"3620",1970-01-01 13:30:00,"88a8a07469fffff",42,82,124
"3621",1970-01-01 13:30:00,"88a8a0746bfffff",324,691,1015
"3622",1970-01-01 13:30:00,"88a8a07507fffff",162,403,565
"3623",1970-01-01 13:30:00,"88a8a07515fffff",0,0,0
"3624",1970-01-01 13:30:00,"88a8a0751dfffff",0,0,0
"3625",1970-01-01 13:30:00,"88a8a07521fffff",273,656,929
"3626",1970-01-01 13:30:00,"88a8a07525fffff",162,403,565
"3627",1970-01-01 13:30:00,"88a8a0752bfffff",213,553,766
"3628",1970-01-01 13:30:00,"88a8a0752dfffff",273,656,929
"3629",1970-01-01 13:30:00,"88a8a07531fffff",255,635,890
"3630",1970-01-01 13:30:00,"88a8a07533fffff",0,0,0
"3631",1970-01-01 13:30:00,"88a8a07535fffff",246,682,928
"3632",1970-01-01 13:30:00,"88a8a07537fffff",60,103,163
"3633",1970-01-01 13:30:00,"88a8a07539fffff",153,335,488
"3634",1970-01-01 13:30:00,"88a8a0753bfffff",0,0,0
"3635",1970-01-01 13:30:00,"88a8a0753dfffff",204,485,689
"3636",1970-01-01 13:30:00,"88a8a07543fffff",222,506,728
"3637",1970-01-01 13:30:00,"88a8a07545fffff",120,206,326
"3638",1970-01-01 13:30:00,"88a8a07547fffff",231,459,690
"3639",1970-01-01 13:30:00,"88a8a07553fffff",0,0,0
"3640",1970-01-01 13:30:00,"88a8a07557fffff",42,82,124
"3641",1970-01-01 13:30:00,"88a8a07559fffff",282,609,891
"3642",1970-01-01 13:30:00,"88a8a0755bfffff",42,82,124
"3643",1970-01-01 13:30:00,"88a8a0755dfffff",282,609,891
"3644",1970-01-01 13:30:00,"88a8a07561fffff",324,806,1130
"3645",1970-01-01 13:30:00,"88a8a07567fffff",222,506,728
"3646",1970-01-01 13:30:00,"88a8a07569fffff",333,759,1092
"3647",1970-01-01 13:30:00,"88a8a0756bfffff",162,403,565
"3648",1970-01-01 13:30:00,"88a8a0756dfffff",497,1161,1658
"3649",1970-01-01 13:30:00,"88a8a07633fffff",222,506,728
"3650",1970-01-01 13:30:00,"88a8a07637fffff",231,459,690
"3651",1970-01-01 13:30:00,"88a8a076c7fffff",60,103,163
"3652",1970-01-01 13:30:00,"88a8a076d3fffff",215,552,767
"3653",1970-01-01 13:30:00,"88a8a076d5fffff",155,449,604
"3654",1970-01-01 13:30:00,"88a8a076d7fffff",104,299,403
"3655",1970-01-01 13:30:00,"88a8a076e9fffff",222,506,728
"3656",1970-01-01 13:30:00,"88a8a076ebfffff",111,253,364
"3657",1970-01-01 13:30:00,"88a8a076edfffff",222,506,728
"3658",1970-01-01 13:30:00,"88a8a078c9fffff",0,0,0
"3659",1970-01-01 13:30:00,"88a8a078cdfffff",0,0,0
"3660",1970-01-01 13:30:00,"88a8a07a91fffff",0,0,0
"3661",1970-01-01 13:30:00,"88a8a07ab1fffff",0,0,0
"3662",1970-01-01 13:30:00,"88a8a07ab5fffff",0,0,0
"3663",1970-01-01 13:30:00,"88a8a07abbfffff",0,0,0
"3664",1970-01-01 14:00:00,"88a8a02801fffff",33,60,93
"3665",1970-01-01 14:00:00,"88a8a02805fffff",33,60,93
"3666",1970-01-01 14:00:00,"88a8a02809fffff",0,0,0
"3667",1970-01-01 14:00:00,"88a8a0280bfffff",33,60,93
"3668",1970-01-01 14:00:00,"88a8a02853fffff",33,60,93
"3669",1970-01-01 14:00:00,"88a8a02857fffff",33,60,93
"3670",1970-01-01 14:00:00,"88a8a02a13fffff",53,149,202
"3671",1970-01-01 14:00:00,"88a8a02a61fffff",51,150,201
"3672",1970-01-01 14:00:00,"88a8a02a69fffff",51,150,201
"3673",1970-01-01 14:00:00,"88a8a02a89fffff",84,210,294
"3674",1970-01-01 14:00:00,"88a8a02a8bfffff",84,210,294
"3675",1970-01-01 14:00:00,"88a8a02a9dfffff",84,210,294
"3676",1970-01-01 14:00:00,"88a8a02aadfffff",33,60,93
"3677",1970-01-01 14:00:00,"88a8a02ac7fffff",84,210,294
"3678",1970-01-01 14:00:00,"88a8a02ae3fffff",33,60,93
"3679",1970-01-01 14:00:00,"88a8a02ae7fffff",33,60,93
"3680",1970-01-01 14:00:00,"88a8a02aebfffff",33,60,93
"3681",1970-01-01 14:00:00,"88a8a03987fffff",102,300,402
"3682",1970-01-01 14:00:00,"88a8a03995fffff",60,103,163
"3683",1970-01-01 14:00:00,"88a8a03997fffff",51,150,201
"3684",1970-01-01 14:00:00,"88a8a039a1fffff",222,506,728
"3685",1970-01-01 14:00:00,"88a8a039abfffff",282,609,891
"3686",1970-01-01 14:00:00,"88a8a039adfffff",282,609,891
"3687",1970-01-01 14:00:00,"88a8a039b9fffff",270,577,847
"3688",1970-01-01 14:00:00,"88a8a039bbfffff",162,403,565
"3689",1970-01-01 14:00:00,"88a8a039bdfffff",60,103,163
"3690",1970-01-01 14:00:00,"88a8a06081fffff",51,150,201
"3691",1970-01-01 14:00:00,"88a8a06085fffff",468,1188,1656
"3692",1970-01-01 14:00:00,"88a8a0608dfffff",366,888,1254
"3693",1970-01-01 14:00:00,"88a8a060a3fffff",162,403,565
"3694",1970-01-01 14:00:00,"88a8a060a7fffff",51,150,201
"3695",1970-01-01 14:00:00,"88a8a060abfffff",213,553,766
"3696",1970-01-01 14:00:00,"88a8a060c1fffff",51,150,201
"3697",1970-01-01 14:00:00,"88a8a060c3fffff",162,403,565
"3698",1970-01-01 14:00:00,"88a8a060c7fffff",213,553,766
"3699",1970-01-01 14:00:00,"88a8a060cbfffff",102,300,402
"3700",1970-01-01 14:00:00,"88a8a06193fffff",51,150,201
"3701",1970-01-01 14:00:00,"88a8a06197fffff",51,150,201
"3702",1970-01-01 14:00:00,"88a8a0619bfffff",102,300,402
"3703",1970-01-01 14:00:00,"88a8a061a1fffff",144,382,526
"3704",1970-01-01 14:00:00,"88a8a061a3fffff",93,232,325
"3705",1970-01-01 14:00:00,"88a8a061a5fffff",144,382,526
"3706",1970-01-01 14:00:00,"88a8a061b1fffff",111,253,364
"3707",1970-01-01 14:00:00,"88a8a061b3fffff",162,403,565
"3708",1970-01-01 14:00:00,"88a8a061b5fffff",144,382,526
"3709",1970-01-01 14:00:00,"88a8a061b7fffff",213,553,766
"3710",1970-01-01 14:00:00,"88a8a06249fffff",324,691,1015
"3711",1970-01-01 14:00:00,"88a8a0624bfffff",384,794,1178
"3712",1970-01-01 14:00:00,"88a8a0624dfffff",444,897,1341
"3713",1970-01-01 14:00:00,"88a8a06281fffff",284,608,892
"3714",1970-01-01 14:00:00,"88a8a06283fffff",419,922,1341
"3715",1970-01-01 14:00:00,"88a8a06287fffff",213,438,651
"3716",1970-01-01 14:00:00,"88a8a06289fffff",368,772,1140
"3717",1970-01-01 14:00:00,"88a8a0628bfffff",162,288,450
"3718",1970-01-01 14:00:00,"88a8a06293fffff",120,206,326
"3719",1970-01-01 14:00:00,"88a8a06299fffff",120,206,326
"3720",1970-01-01 14:00:00,"88a8a0629bfffff",120,206,326
"3721",1970-01-01 14:00:00,"88a8a062b5fffff",204,485,689
"3722",1970-01-01 14:00:00,"88a8a062bdfffff",213,438,651
"3723",1970-01-01 14:00:00,"88a8a062c1fffff",266,587,853
"3724",1970-01-01 14:00:00,"88a8a062c3fffff",308,669,977
"3725",1970-01-01 14:00:00,"88a8a062cbfffff",155,334,489
"3726",1970-01-01 14:00:00,"88a8a062d1fffff",60,103,163
"3727",1970-01-01 14:00:00,"88a8a062d3fffff",120,206,326
"3728",1970-01-01 14:00:00,"88a8a062d9fffff",0,0,0
"3729",1970-01-01 14:00:00,"88a8a06541fffff",60,103,163
"3730",1970-01-01 14:00:00,"88a8a06549fffff",120,206,326
"3731",1970-01-01 14:00:00,"88a8a06705fffff",120,206,326
"3732",1970-01-01 14:00:00,"88a8a0670dfffff",60,103,163
"3733",1970-01-01 14:00:00,"88a8a06731fffff",60,103,163
"3734",1970-01-01 14:00:00,"88a8a06735fffff",120,206,326
"3735",1970-01-01 14:00:00,"88a8a06739fffff",120,206,326
"3736",1970-01-01 14:00:00,"88a8a0674dfffff",120,206,326
"3737",1970-01-01 14:00:00,"88a8a0676bfffff",120,206,326
"3738",1970-01-01 14:00:00,"88a8a06a91fffff",51,150,201
"3739",1970-01-01 14:00:00,"88a8a06a9bfffff",51,150,201
"3740",1970-01-01 14:00:00,"88a8a06e49fffff",162,403,565
"3741",1970-01-01 14:00:00,"88a8a06e4dfffff",162,403,565
"3742",1970-01-01 14:00:00,"88a8a06e69fffff",60,103,163
"3743",1970-01-01 14:00:00,"88a8a06e6dfffff",162,403,565
"3744",1970-01-01 14:00:00,"88a8a06f05fffff",51,150,201
"3745",1970-01-01 14:00:00,"88a8a06f63fffff",102,300,402
"3746",1970-01-01 14:00:00,"88a8a06f67fffff",51,150,201
"3747",1970-01-01 14:00:00,"88a8a06f69fffff",102,300,402
"3748",1970-01-01 14:00:00,"88a8a07097fffff",0,0,0
"3749",1970-01-01 14:00:00,"88a8a070a3fffff",0,0,0
"3750",1970-01-01 14:00:00,"88a8a070a7fffff",0,0,0
"3751",1970-01-01 14:00:00,"88a8a070b1fffff",0,0,0
"3752",1970-01-01 14:00:00,"88a8a070b3fffff",444,897,1341
"3753",1970-01-01 14:00:00,"88a8a070b7fffff",444,897,1341
"3754",1970-01-01 14:00:00,"88a8a070bbfffff",0,0,0
"3755",1970-01-01 14:00:00,"88a8a07199fffff",0,0,0
"3756",1970-01-01 14:00:00,"88a8a0719bfffff",333,644,977
"3757",1970-01-01 14:00:00,"88a8a07441fffff",263,623,886
"3758",1970-01-01 14:00:00,"88a8a07445fffff",104,299,403
"3759",1970-01-01 14:00:00,"88a8a07447fffff",215,552,767
"3760",1970-01-01 14:00:00,"88a8a0744bfffff",162,403,565
"3761",1970-01-01 14:00:00,"88a8a07461fffff",428,990,1418
"3762",1970-01-01 14:00:00,"88a8a07465fffff",448,1010,1458
"3763",1970-01-01 14:00:00,"88a8a07469fffff",48,96,144
"3764",1970-01-01 14:00:00,"88a8a0746bfffff",257,634,891
"3765",1970-01-01 14:00:00,"88a8a07503fffff",0,0,0
"3766",1970-01-01 14:00:00,"88a8a07507fffff",402,700,1102
"3767",1970-01-01 14:00:00,"88a8a07515fffff",120,206,326
"3768",1970-01-01 14:00:00,"88a8a0751dfffff",60,103,163
"3769",1970-01-01 14:00:00,"88a8a07521fffff",393,747,1140
"3770",1970-01-01 14:00:00,"88a8a07525fffff",120,206,326
"3771",1970-01-01 14:00:00,"88a8a0752bfffff",393,747,1140
"3772",1970-01-01 14:00:00,"88a8a0752dfffff",393,747,1140
"3773",1970-01-01 14:00:00,"88a8a07531fffff",377,725,1102
"3774",1970-01-01 14:00:00,"88a8a07533fffff",0,0,0
"3775",1970-01-01 14:00:00,"88a8a07535fffff",255,520,775
"3776",1970-01-01 14:00:00,"88a8a07537fffff",60,103,163
"3777",1970-01-01 14:00:00,"88a8a07539fffff",453,850,1303
"3778",1970-01-01 14:00:00,"88a8a0753dfffff",291,562,853
"3779",1970-01-01 14:00:00,"88a8a07543fffff",457,963,1420
"3780",1970-01-01 14:00:00,"88a8a07545fffff",224,505,729
"3781",1970-01-01 14:00:00,"88a8a07547fffff",335,758,1093
"3782",1970-01-01 14:00:00,"88a8a07553fffff",102,185,287
"3783",1970-01-01 14:00:00,"88a8a07557fffff",60,103,163
"3784",1970-01-01 14:00:00,"88a8a07559fffff",457,963,1420
"3785",1970-01-01 14:00:00,"88a8a0755bfffff",102,185,287
"3786",1970-01-01 14:00:00,"88a8a0755dfffff",397,860,1257
"3787",1970-01-01 14:00:00,"88a8a07561fffff",504,885,1389
"3788",1970-01-01 14:00:00,"88a8a07567fffff",435,829,1264
"3789",1970-01-01 14:00:00,"88a8a07569fffff",383,829,1212
"3790",1970-01-01 14:00:00,"88a8a0756bfffff",217,551,768
"3791",1970-01-01 14:00:00,"88a8a0756dfffff",812,1669,2481
"3792",1970-01-01 14:00:00,"88a8a07633fffff",99,221,320
"3793",1970-01-01 14:00:00,"88a8a07637fffff",51,150,201
"3794",1970-01-01 14:00:00,"88a8a076c7fffff",60,103,163
"3795",1970-01-01 14:00:00,"88a8a076d1fffff",120,206,326
"3796",1970-01-01 14:00:00,"88a8a076d3fffff",231,459,690
"3797",1970-01-01 14:00:00,"88a8a076d5fffff",120,206,326
"3798",1970-01-01 14:00:00,"88a8a076e9fffff",99,221,320
"3799",1970-01-01 14:00:00,"88a8a076edfffff",99,221,320
"3800",1970-01-01 14:30:00,"88a8a02801fffff",33,60,93
"3801",1970-01-01 14:30:00,"88a8a02805fffff",33,60,93
"3802",1970-01-01 14:30:00,"88a8a02809fffff",51,150,201
"3803",1970-01-01 14:30:00,"88a8a0280bfffff",66,120,186
"3804",1970-01-01 14:30:00,"88a8a02829fffff",33,60,93
"3805",1970-01-01 14:30:00,"88a8a0282dfffff",33,60,93
"3806",1970-01-01 14:30:00,"88a8a02853fffff",33,60,93
"3807",1970-01-01 14:30:00,"88a8a02857fffff",33,60,93
"3808",1970-01-01 14:30:00,"88a8a02a01fffff",206,599,805
"3809",1970-01-01 14:30:00,"88a8a02a05fffff",203,520,723
"3810",1970-01-01 14:30:00,"88a8a02a61fffff",53,149,202
"3811",1970-01-01 14:30:00,"88a8a02a63fffff",155,449,604
"3812",1970-01-01 14:30:00,"88a8a02a69fffff",203,520,723
"3813",1970-01-01 14:30:00,"88a8a02a6dfffff",51,150,201
"3814",1970-01-01 14:30:00,"88a8a02a89fffff",84,210,294
"3815",1970-01-01 14:30:00,"88a8a02a8bfffff",84,210,294
"3816",1970-01-01 14:30:00,"88a8a02a9dfffff",51,150,201
"3817",1970-01-01 14:30:00,"88a8a02aadfffff",33,60,93
"3818",1970-01-01 14:30:00,"88a8a02ac5fffff",51,150,201
"3819",1970-01-01 14:30:00,"88a8a02ac7fffff",84,210,294
"3820",1970-01-01 14:30:00,"88a8a02ae3fffff",33,60,93
"3821",1970-01-01 14:30:00,"88a8a02ae7fffff",33,60,93
"3822",1970-01-01 14:30:00,"88a8a02aebfffff",33,60,93
"3823",1970-01-01 14:30:00,"88a8a03987fffff",51,150,201
"3824",1970-01-01 14:30:00,"88a8a03995fffff",60,103,163
"3825",1970-01-01 14:30:00,"88a8a03997fffff",104,299,403
"3826",1970-01-01 14:30:00,"88a8a039a1fffff",164,402,566
"3827",1970-01-01 14:30:00,"88a8a039abfffff",164,402,566
"3828",1970-01-01 14:30:00,"88a8a039adfffff",60,103,163
"3829",1970-01-01 14:30:00,"88a8a039b9fffff",164,402,566
"3830",1970-01-01 14:30:00,"88a8a039bbfffff",104,299,403
"3831",1970-01-01 14:30:00,"88a8a039bdfffff",60,103,163
"3832",1970-01-01 14:30:00,"88a8a06085fffff",266,587,853
"3833",1970-01-01 14:30:00,"88a8a0608dfffff",395,861,1256
"3834",1970-01-01 14:30:00,"88a8a060a3fffff",264,703,967
"3835",1970-01-01 14:30:00,"88a8a060a7fffff",162,403,565
"3836",1970-01-01 14:30:00,"88a8a060abfffff",213,553,766
"3837",1970-01-01 14:30:00,"88a8a060c1fffff",113,252,365
"3838",1970-01-01 14:30:00,"88a8a060c3fffff",386,793,1179
"3839",1970-01-01 14:30:00,"88a8a060c7fffff",335,758,1093
"3840",1970-01-01 14:30:00,"88a8a060cbfffff",497,1046,1543
"3841",1970-01-01 14:30:00,"88a8a06193fffff",162,403,565
"3842",1970-01-01 14:30:00,"88a8a06197fffff",102,300,402
"3843",1970-01-01 14:30:00,"88a8a0619bfffff",60,103,163
"3844",1970-01-01 14:30:00,"88a8a061a1fffff",204,600,804
"3845",1970-01-01 14:30:00,"88a8a061a3fffff",153,450,603
"3846",1970-01-01 14:30:00,"88a8a061a5fffff",153,450,603
"3847",1970-01-01 14:30:00,"88a8a061b1fffff",213,553,766
"3848",1970-01-01 14:30:00,"88a8a061b3fffff",315,853,1168
"3849",1970-01-01 14:30:00,"88a8a061b5fffff",204,600,804
"3850",1970-01-01 14:30:00,"88a8a061b7fffff",477,1256,1733
"3851",1970-01-01 14:30:00,"88a8a06249fffff",624,1091,1715
"3852",1970-01-01 14:30:00,"88a8a0624bfffff",546,967,1513
"3853",1970-01-01 14:30:00,"88a8a0624dfffff",624,1091,1715
"3854",1970-01-01 14:30:00,"88a8a06281fffff",222,506,728
"3855",1970-01-01 14:30:00,"88a8a06283fffff",342,712,1054
"3856",1970-01-01 14:30:00,"88a8a06287fffff",386,908,1294
"3857",1970-01-01 14:30:00,"88a8a06289fffff",384,794,1178
"3858",1970-01-01 14:30:00,"88a8a0628bfffff",213,438,651
"3859",1970-01-01 14:30:00,"88a8a06293fffff",60,103,163
"3860",1970-01-01 14:30:00,"88a8a06299fffff",120,206,326
"3861",1970-01-01 14:30:00,"88a8a0629bfffff",120,206,326
"3862",1970-01-01 14:30:00,"88a8a062b5fffff",395,861,1256
"3863",1970-01-01 14:30:00,"88a8a062bdfffff",446,1011,1457
"3864",1970-01-01 14:30:00,"88a8a062c1fffff",171,356,527
"3865",1970-01-01 14:30:00,"88a8a062c3fffff",393,747,1140
"3866",1970-01-01 14:30:00,"88a8a062cbfffff",444,897,1341
"3867",1970-01-01 14:30:00,"88a8a062d1fffff",180,309,489
"3868",1970-01-01 14:30:00,"88a8a062d3fffff",120,206,326
"3869",1970-01-01 14:30:00,"88a8a062d9fffff",240,412,652
"3870",1970-01-01 14:30:00,"88a8a06705fffff",120,206,326
"3871",1970-01-01 14:30:00,"88a8a06707fffff",60,103,163
"3872",1970-01-01 14:30:00,"88a8a0670dfffff",120,206,326
"3873",1970-01-01 14:30:00,"88a8a0672bfffff",60,103,163
"3874",1970-01-01 14:30:00,"88a8a06731fffff",60,103,163
"3875",1970-01-01 14:30:00,"88a8a06739fffff",60,103,163
"3876",1970-01-01 14:30:00,"88a8a0676bfffff",120,206,326
"3877",1970-01-01 14:30:00,"88a8a06a91fffff",51,150,201
"3878",1970-01-01 14:30:00,"88a8a06a9bfffff",153,450,603
"3879",1970-01-01 14:30:00,"88a8a06e49fffff",102,300,402
"3880",1970-01-01 14:30:00,"88a8a06e4dfffff",315,853,1168
"3881",1970-01-01 14:30:00,"88a8a06e69fffff",51,150,201
"3882",1970-01-01 14:30:00,"88a8a06e6dfffff",315,853,1168
"3883",1970-01-01 14:30:00,"88a8a06f05fffff",51,150,201
"3884",1970-01-01 14:30:00,"88a8a06f61fffff",51,150,201
"3885",1970-01-01 14:30:00,"88a8a06f63fffff",102,300,402
"3886",1970-01-01 14:30:00,"88a8a06f67fffff",51,150,201
"3887",1970-01-01 14:30:00,"88a8a06f69fffff",0,0,0
"3888",1970-01-01 14:30:00,"88a8a070b3fffff",588,1049,1637
"3889",1970-01-01 14:30:00,"88a8a070b7fffff",624,1091,1715
"3890",1970-01-01 14:30:00,"88a8a0719bfffff",402,700,1102
"3891",1970-01-01 14:30:00,"88a8a07441fffff",284,608,892
"3892",1970-01-01 14:30:00,"88a8a07445fffff",113,252,365
"3893",1970-01-01 14:30:00,"88a8a07447fffff",180,309,489
"3894",1970-01-01 14:30:00,"88a8a0744bfffff",284,608,892
"3895",1970-01-01 14:30:00,"88a8a07461fffff",566,1217,1783
"3896",1970-01-01 14:30:00,"88a8a07465fffff",282,609,891
"3897",1970-01-01 14:30:00,"88a8a07467fffff",180,309,489
"3898",1970-01-01 14:30:00,"88a8a07469fffff",60,103,163
"3899",1970-01-01 14:30:00,"88a8a0746bfffff",404,814,1218
"3900",1970-01-01 14:30:00,"88a8a07507fffff",411,768,1179
"3901",1970-01-01 14:30:00,"88a8a07515fffff",453,965,1418
"3902",1970-01-01 14:30:00,"88a8a0751dfffff",222,506,728
"3903",1970-01-01 14:30:00,"88a8a07521fffff",453,850,1303
"3904",1970-01-01 14:30:00,"88a8a07525fffff",351,665,1016
"3905",1970-01-01 14:30:00,"88a8a0752bfffff",504,1000,1504
"3906",1970-01-01 14:30:00,"88a8a0752dfffff",342,597,939
"3907",1970-01-01 14:30:00,"88a8a07531fffff",744,1412,2156
"3908",1970-01-01 14:30:00,"88a8a07533fffff",180,309,489
"3909",1970-01-01 14:30:00,"88a8a07535fffff",384,794,1178
"3910",1970-01-01 14:30:00,"88a8a07537fffff",240,412,652
"3911",1970-01-01 14:30:00,"88a8a07539fffff",453,850,1303
"3912",1970-01-01 14:30:00,"88a8a0753bfffff",51,150,201
"3913",1970-01-01 14:30:00,"88a8a0753dfffff",231,459,690
"3914",1970-01-01 14:30:00,"88a8a07543fffff",504,1115,1619
"3915",1970-01-01 14:30:00,"88a8a07545fffff",180,309,489
"3916",1970-01-01 14:30:00,"88a8a07547fffff",504,1115,1619
"3917",1970-01-01 14:30:00,"88a8a07553fffff",120,206,326
"3918",1970-01-01 14:30:00,"88a8a07557fffff",120,206,326
"3919",1970-01-01 14:30:00,"88a8a07559fffff",513,1068,1581
"3920",1970-01-01 14:30:00,"88a8a0755bfffff",171,356,527
"3921",1970-01-01 14:30:00,"88a8a0755dfffff",453,965,1418
"3922",1970-01-01 14:30:00,"88a8a07561fffff",342,597,939
"3923",1970-01-01 14:30:00,"88a8a07565fffff",0,0,0
"3924",1970-01-01 14:30:00,"88a8a07567fffff",342,597,939
"3925",1970-01-01 14:30:00,"88a8a07569fffff",333,759,1092
"3926",1970-01-01 14:30:00,"88a8a0756bfffff",282,609,891
"3927",1970-01-01 14:30:00,"88a8a0756dfffff",621,1178,1799
"3928",1970-01-01 14:30:00,"88a8a07633fffff",395,861,1256
"3929",1970-01-01 14:30:00,"88a8a07637fffff",335,758,1093
"3930",1970-01-01 14:30:00,"88a8a076c7fffff",113,252,365
"3931",1970-01-01 14:30:00,"88a8a076d1fffff",111,253,364
"3932",1970-01-01 14:30:00,"88a8a076d3fffff",224,505,729
"3933",1970-01-01 14:30:00,"88a8a076d5fffff",162,403,565
"3934",1970-01-01 14:30:00,"88a8a076d7fffff",120,206,326
"3935",1970-01-01 14:30:00,"88a8a076e9fffff",173,355,528
"3936",1970-01-01 14:30:00,"88a8a076ebfffff",173,355,528
"3937",1970-01-01 14:30:00,"88a8a076edfffff",233,458,691
"3938",1970-01-01 15:00:00,"88a8a02801fffff",84,210,294
"3939",1970-01-01 15:00:00,"88a8a02805fffff",33,60,93
"3940",1970-01-01 15:00:00,"88a8a02809fffff",0,0,0
"3941",1970-01-01 15:00:00,"88a8a0280bfffff",33,60,93
"3942",1970-01-01 15:00:00,"88a8a02825fffff",33,60,93
"3943",1970-01-01 15:00:00,"88a8a02829fffff",33,60,93
"3944",1970-01-01 15:00:00,"88a8a0282dfffff",33,60,93
"3945",1970-01-01 15:00:00,"88a8a02853fffff",33,60,93
"3946",1970-01-01 15:00:00,"88a8a02857fffff",33,60,93
"3947",1970-01-01 15:00:00,"88a8a02919fffff",33,60,93
"3948",1970-01-01 15:00:00,"88a8a0291dfffff",33,60,93
"3949",1970-01-01 15:00:00,"88a8a02953fffff",66,120,186
"3950",1970-01-01 15:00:00,"88a8a02957fffff",33,60,93
"3951",1970-01-01 15:00:00,"88a8a02a01fffff",48,71,119
"3952",1970-01-01 15:00:00,"88a8a02a05fffff",48,71,119
"3953",1970-01-01 15:00:00,"88a8a02a11fffff",0,0,0
"3954",1970-01-01 15:00:00,"88a8a02a13fffff",51,150,201
"3955",1970-01-01 15:00:00,"88a8a02a19fffff",0,0,0
"3956",1970-01-01 15:00:00,"88a8a02a57fffff",48,71,119
"3957",1970-01-01 15:00:00,"88a8a02a61fffff",0,0,0
"3958",1970-01-01 15:00:00,"88a8a02a89fffff",102,300,402
"3959",1970-01-01 15:00:00,"88a8a02a8bfffff",102,300,402
"3960",1970-01-01 15:00:00,"88a8a02a9dfffff",51,150,201
"3961",1970-01-01 15:00:00,"88a8a02aadfffff",0,0,0
"3962",1970-01-01 15:00:00,"88a8a02ac5fffff",51,150,201
"3963",1970-01-01 15:00:00,"88a8a02ac7fffff",102,300,402
"3964",1970-01-01 15:00:00,"88a8a02ae3fffff",0,0,0
"3965",1970-01-01 15:00:00,"88a8a02ae7fffff",0,0,0
"3966",1970-01-01 15:00:00,"88a8a03995fffff",60,103,163
"3967",1970-01-01 15:00:00,"88a8a039a1fffff",120,206,326
"3968",1970-01-01 15:00:00,"88a8a039abfffff",120,206,326
"3969",1970-01-01 15:00:00,"88a8a039adfffff",162,403,565
"3970",1970-01-01 15:00:00,"88a8a039b9fffff",108,174,282
"3971",1970-01-01 15:00:00,"88a8a039bbfffff",108,174,282
"3972",1970-01-01 15:00:00,"88a8a06085fffff",437,1058,1495
"3973",1970-01-01 15:00:00,"88a8a0608dfffff",326,690,1016
"3974",1970-01-01 15:00:00,"88a8a060a3fffff",264,703,967
"3975",1970-01-01 15:00:00,"88a8a060a7fffff",51,150,201
"3976",1970-01-01 15:00:00,"88a8a060abfffff",213,553,766
"3977",1970-01-01 15:00:00,"88a8a060c1fffff",53,149,202
"3978",1970-01-01 15:00:00,"88a8a060c3fffff",173,355,528
"3979",1970-01-01 15:00:00,"88a8a060c7fffff",224,505,729
"3980",1970-01-01 15:00:00,"88a8a060cbfffff",275,655,930
"3981",1970-01-01 15:00:00,"88a8a06193fffff",213,553,766
"3982",1970-01-01 15:00:00,"88a8a06197fffff",213,553,766
"3983",1970-01-01 15:00:00,"88a8a0619bfffff",162,403,565
"3984",1970-01-01 15:00:00,"88a8a061a1fffff",150,396,546
"3985",1970-01-01 15:00:00,"88a8a061a3fffff",201,546,747
"3986",1970-01-01 15:00:00,"88a8a061a5fffff",102,300,402
"3987",1970-01-01 15:00:00,"88a8a061b1fffff",162,403,565
"3988",1970-01-01 15:00:00,"88a8a061b3fffff",372,902,1274
"3989",1970-01-01 15:00:00,"88a8a061b5fffff",252,696,948
"3990",1970-01-01 15:00:00,"88a8a061b7fffff",414,1099,1513
"3991",1970-01-01 15:00:00,"88a8a06249fffff",240,412,652
"3992",1970-01-01 15:00:00,"88a8a0624bfffff",240,412,652
"3993",1970-01-01 15:00:00,"88a8a0624dfffff",240,412,652
"3994",1970-01-01 15:00:00,"88a8a06281fffff",162,288,450
"3995",1970-01-01 15:00:00,"88a8a06283fffff",264,588,852
"3996",1970-01-01 15:00:00,"88a8a06287fffff",213,438,651
"3997",1970-01-01 15:00:00,"88a8a06289fffff",120,206,326
"3998",1970-01-01 15:00:00,"88a8a06293fffff",60,103,163
"3999",1970-01-01 15:00:00,"88a8a0629bfffff",60,103,163
"4000",1970-01-01 15:00:00,"88a8a062b5fffff",266,587,853
"4001",1970-01-01 15:00:00,"88a8a062bdfffff",317,737,1054
"4002",1970-01-01 15:00:00,"88a8a062c3fffff",60,103,163
"4003",1970-01-01 15:00:00,"88a8a062cbfffff",60,103,163
"4004",1970-01-01 15:00:00,"88a8a062d1fffff",60,103,163
"4005",1970-01-01 15:00:00,"88a8a062d3fffff",60,103,163
"4006",1970-01-01 15:00:00,"88a8a062d9fffff",60,103,163
"4007",1970-01-01 15:00:00,"88a8a06541fffff",60,103,163
"4008",1970-01-01 15:00:00,"88a8a06735fffff",120,206,326
"4009",1970-01-01 15:00:00,"88a8a0674dfffff",60,103,163
"4010",1970-01-01 15:00:00,"88a8a06a91fffff",51,150,201
"4011",1970-01-01 15:00:00,"88a8a06a9bfffff",51,150,201
"4012",1970-01-01 15:00:00,"88a8a06e49fffff",264,703,967
"4013",1970-01-01 15:00:00,"88a8a06e4dfffff",213,553,766
"4014",1970-01-01 15:00:00,"88a8a06e69fffff",102,300,402
"4015",1970-01-01 15:00:00,"88a8a06e6dfffff",273,656,929
"4016",1970-01-01 15:00:00,"88a8a06f05fffff",51,150,201
"4017",1970-01-01 15:00:00,"88a8a06f61fffff",102,300,402
"4018",1970-01-01 15:00:00,"88a8a06f63fffff",102,300,402
"4019",1970-01-01 15:00:00,"88a8a06f67fffff",102,300,402
"4020",1970-01-01 15:00:00,"88a8a06f69fffff",102,300,402
"4021",1970-01-01 15:00:00,"88a8a070b3fffff",180,309,489
"4022",1970-01-01 15:00:00,"88a8a070b7fffff",300,515,815
"4023",1970-01-01 15:00:00,"88a8a0719bfffff",120,206,326
"4024",1970-01-01 15:00:00,"88a8a07441fffff",219,427,646
"4025",1970-01-01 15:00:00,"88a8a07445fffff",102,300,402
"4026",1970-01-01 15:00:00,"88a8a07447fffff",171,356,527
"4027",1970-01-01 15:00:00,"88a8a0744bfffff",162,403,565
"4028",1970-01-01 15:00:00,"88a8a07461fffff",950,2126,3076
"4029",1970-01-01 15:00:00,"88a8a07465fffff",677,1470,2147
"4030",1970-01-01 15:00:00,"88a8a07467fffff",111,253,364
"4031",1970-01-01 15:00:00,"88a8a07469fffff",111,253,364
"4032",1970-01-01 15:00:00,"88a8a0746bfffff",608,1414,2022
"4033",1970-01-01 15:00:00,"88a8a07503fffff",60,103,163
"4034",1970-01-01 15:00:00,"88a8a07507fffff",240,412,652
"4035",1970-01-01 15:00:00,"88a8a07515fffff",120,206,326
"4036",1970-01-01 15:00:00,"88a8a0751dfffff",60,103,163
"4037",1970-01-01 15:00:00,"88a8a07521fffff",300,515,815
"4038",1970-01-01 15:00:00,"88a8a07525fffff",300,515,815
"4039",1970-01-01 15:00:00,"88a8a0752bfffff",240,412,652
"4040",1970-01-01 15:00:00,"88a8a0752dfffff",411,768,1179
"4041",1970-01-01 15:00:00,"88a8a07531fffff",231,459,690
"4042",1970-01-01 15:00:00,"88a8a07535fffff",111,253,364
"4043",1970-01-01 15:00:00,"88a8a07537fffff",120,206,326
"4044",1970-01-01 15:00:00,"88a8a07539fffff",300,515,815
"4045",1970-01-01 15:00:00,"88a8a0753bfffff",120,206,326
"4046",1970-01-01 15:00:00,"88a8a0753dfffff",60,103,163
"4047",1970-01-01 15:00:00,"88a8a07543fffff",575,1170,1745
"4048",1970-01-01 15:00:00,"88a8a07545fffff",240,412,652
"4049",1970-01-01 15:00:00,"88a8a07547fffff",515,1067,1582
"4050",1970-01-01 15:00:00,"88a8a07553fffff",162,403,565
"4051",1970-01-01 15:00:00,"88a8a07557fffff",111,253,364
"4052",1970-01-01 15:00:00,"88a8a07559fffff",515,1067,1582
"4053",1970-01-01 15:00:00,"88a8a0755bfffff",162,403,565
"4054",1970-01-01 15:00:00,"88a8a0755dfffff",515,1067,1582
"4055",1970-01-01 15:00:00,"88a8a07561fffff",582,1009,1591
"4056",1970-01-01 15:00:00,"88a8a07565fffff",60,103,163
"4057",1970-01-01 15:00:00,"88a8a07567fffff",471,871,1342
"4058",1970-01-01 15:00:00,"88a8a07569fffff",506,1114,1620
"4059",1970-01-01 15:00:00,"88a8a0756bfffff",395,861,1256
"4060",1970-01-01 15:00:00,"88a8a0756dfffff",651,1180,1831
"4061",1970-01-01 15:00:00,"88a8a07633fffff",210,474,684
"4062",1970-01-01 15:00:00,"88a8a07637fffff",111,253,364
"4063",1970-01-01 15:00:00,"88a8a076c7fffff",222,506,728
"4064",1970-01-01 15:00:00,"88a8a076d1fffff",111,253,364
"4065",1970-01-01 15:00:00,"88a8a076d3fffff",111,253,364
"4066",1970-01-01 15:00:00,"88a8a076d7fffff",0,0,0
"4067",1970-01-01 15:00:00,"88a8a076e9fffff",162,403,565
"4068",1970-01-01 15:00:00,"88a8a076ebfffff",162,403,565
"4069",1970-01-01 15:00:00,"88a8a076edfffff",162,403,565
"4070",1970-01-01 15:30:00,"88a8a02801fffff",0,0,0
"4071",1970-01-01 15:30:00,"88a8a02809fffff",0,0,0
"4072",1970-01-01 15:30:00,"88a8a0280bfffff",51,150,201
"4073",1970-01-01 15:30:00,"88a8a02853fffff",51,150,201
"4074",1970-01-01 15:30:00,"88a8a02857fffff",51,150,201
"4075",1970-01-01 15:30:00,"88a8a02a01fffff",102,300,402
"4076",1970-01-01 15:30:00,"88a8a02a05fffff",155,449,604
"4077",1970-01-01 15:30:00,"88a8a02a0bfffff",51,150,201
"4078",1970-01-01 15:30:00,"88a8a02a0dfffff",102,300,402
"4079",1970-01-01 15:30:00,"88a8a02a11fffff",51,150,201
"4080",1970-01-01 15:30:00,"88a8a02a13fffff",51,150,201
"4081",1970-01-01 15:30:00,"88a8a02a19fffff",102,300,402
"4082",1970-01-01 15:30:00,"88a8a02a57fffff",0,0,0
"4083",1970-01-01 15:30:00,"88a8a02a61fffff",104,299,403
"4084",1970-01-01 15:30:00,"88a8a02a63fffff",104,299,403
"4085",1970-01-01 15:30:00,"88a8a02a69fffff",155,449,604
"4086",1970-01-01 15:30:00,"88a8a02a89fffff",84,210,294
"4087",1970-01-01 15:30:00,"88a8a02a8bfffff",84,210,294
"4088",1970-01-01 15:30:00,"88a8a02a9dfffff",33,60,93
"4089",1970-01-01 15:30:00,"88a8a02aa9fffff",51,150,201
"4090",1970-01-01 15:30:00,"88a8a02aadfffff",84,210,294
"4091",1970-01-01 15:30:00,"88a8a02ac5fffff",102,300,402
"4092",1970-01-01 15:30:00,"88a8a02ac7fffff",135,360,495
"4093",1970-01-01 15:30:00,"88a8a02ae3fffff",84,210,294
"4094",1970-01-01 15:30:00,"88a8a02ae7fffff",84,210,294
"4095",1970-01-01 15:30:00,"88a8a02aebfffff",84,210,294
"4096",1970-01-01 15:30:00,"88a8a03987fffff",51,150,201
"4097",1970-01-01 15:30:00,"88a8a03995fffff",231,459,690
"4098",1970-01-01 15:30:00,"88a8a03997fffff",155,449,604
"4099",1970-01-01 15:30:00,"88a8a039a1fffff",328,804,1132
"4100",1970-01-01 15:30:00,"88a8a039abfffff",328,804,1132
"4101",1970-01-01 15:30:00,"88a8a039adfffff",277,654,931
"4102",1970-01-01 15:30:00,"88a8a039b9fffff",335,758,1093
"4103",1970-01-01 15:30:00,"88a8a039bbfffff",326,805,1131
"4104",1970-01-01 15:30:00,"88a8a039bdfffff",113,252,365
"4105",1970-01-01 15:30:00,"88a8a06081fffff",60,103,163
"4106",1970-01-01 15:30:00,"88a8a06085fffff",564,1380,1944
"4107",1970-01-01 15:30:00,"88a8a0608dfffff",480,1101,1581
"4108",1970-01-01 15:30:00,"88a8a060a3fffff",141,328,469
"4109",1970-01-01 15:30:00,"88a8a060abfffff",144,382,526
"4110",1970-01-01 15:30:00,"88a8a060c1fffff",60,103,163
"4111",1970-01-01 15:30:00,"88a8a060c3fffff",231,459,690
"4112",1970-01-01 15:30:00,"88a8a060c7fffff",333,759,1092
"4113",1970-01-01 15:30:00,"88a8a060cbfffff",222,506,728
"4114",1970-01-01 15:30:00,"88a8a06193fffff",99,246,345
"4115",1970-01-01 15:30:00,"88a8a06197fffff",150,396,546
"4116",1970-01-01 15:30:00,"88a8a061a1fffff",51,150,201
"4117",1970-01-01 15:30:00,"88a8a061a3fffff",51,150,201
"4118",1970-01-01 15:30:00,"88a8a061a5fffff",51,150,201
"4119",1970-01-01 15:30:00,"88a8a061b1fffff",144,382,526
"4120",1970-01-01 15:30:00,"88a8a061b3fffff",144,382,526
"4121",1970-01-01 15:30:00,"88a8a061b5fffff",171,356,527
"4122",1970-01-01 15:30:00,"88a8a061b7fffff",255,520,775
"4123",1970-01-01 15:30:00,"88a8a06249fffff",480,824,1304
"4124",1970-01-01 15:30:00,"88a8a0624bfffff",480,824,1304
"4125",1970-01-01 15:30:00,"88a8a0624dfffff",420,721,1141
"4126",1970-01-01 15:30:00,"88a8a06281fffff",150,396,546
"4127",1970-01-01 15:30:00,"88a8a06283fffff",150,396,546
"4128",1970-01-01 15:30:00,"88a8a06287fffff",162,403,565
"4129",1970-01-01 15:30:00,"88a8a06289fffff",201,546,747
"4130",1970-01-01 15:30:00,"88a8a0628bfffff",102,300,402
"4131",1970-01-01 15:30:00,"88a8a06293fffff",240,412,652
"4132",1970-01-01 15:30:00,"88a8a06299fffff",180,309,489
"4133",1970-01-01 15:30:00,"88a8a0629bfffff",240,412,652
"4134",1970-01-01 15:30:00,"88a8a062b5fffff",111,253,364
"4135",1970-01-01 15:30:00,"88a8a062bdfffff",162,403,565
"4136",1970-01-01 15:30:00,"88a8a062c1fffff",150,396,546
"4137",1970-01-01 15:30:00,"88a8a062c3fffff",99,246,345
"4138",1970-01-01 15:30:00,"88a8a062cbfffff",201,546,747
"4139",1970-01-01 15:30:00,"88a8a062d1fffff",240,412,652
"4140",1970-01-01 15:30:00,"88a8a062d3fffff",240,412,652
"4141",1970-01-01 15:30:00,"88a8a062d9fffff",240,412,652
"4142",1970-01-01 15:30:00,"88a8a06541fffff",60,103,163
"4143",1970-01-01 15:30:00,"88a8a06549fffff",120,206,326
"4144",1970-01-01 15:30:00,"88a8a06705fffff",300,515,815
"4145",1970-01-01 15:30:00,"88a8a06707fffff",120,206,326
"4146",1970-01-01 15:30:00,"88a8a0670dfffff",120,206,326
"4147",1970-01-01 15:30:00,"88a8a0672bfffff",180,309,489
"4148",1970-01-01 15:30:00,"88a8a06731fffff",60,103,163
"4149",1970-01-01 15:30:00,"88a8a06735fffff",120,206,326
"4150",1970-01-01 15:30:00,"88a8a06739fffff",120,206,326
"4151",1970-01-01 15:30:00,"88a8a0673dfffff",60,103,163
"4152",1970-01-01 15:30:00,"88a8a0674dfffff",180,309,489
"4153",1970-01-01 15:30:00,"88a8a0676bfffff",120,206,326
"4154",1970-01-01 15:30:00,"88a8a06a91fffff",51,150,201
"4155",1970-01-01 15:30:00,"88a8a06a9bfffff",51,150,201
"4156",1970-01-01 15:30:00,"88a8a06e49fffff",99,246,345
"4157",1970-01-01 15:30:00,"88a8a06e4dfffff",99,246,345
"4158",1970-01-01 15:30:00,"88a8a06e69fffff",99,246,345
"4159",1970-01-01 15:30:00,"88a8a06e6dfffff",243,628,871
"4160",1970-01-01 15:30:00,"88a8a06f05fffff",0,0,0
"4161",1970-01-01 15:30:00,"88a8a070b3fffff",360,618,978
"4162",1970-01-01 15:30:00,"88a8a070b7fffff",360,618,978
"4163",1970-01-01 15:30:00,"88a8a0719bfffff",180,309,489
"4164",1970-01-01 15:30:00,"88a8a07441fffff",284,608,892
"4165",1970-01-01 15:30:00,"88a8a07445fffff",120,206,326
"4166",1970-01-01 15:30:00,"88a8a07447fffff",173,355,528
"4167",1970-01-01 15:30:00,"88a8a0744bfffff",344,711,1055
"4168",1970-01-01 15:30:00,"88a8a07461fffff",471,871,1342
"4169",1970-01-01 15:30:00,"88a8a07465fffff",411,768,1179
"4170",1970-01-01 15:30:00,"88a8a07467fffff",60,103,163
"4171",1970-01-01 15:30:00,"88a8a0746bfffff",348,586,934
"4172",1970-01-01 15:30:00,"88a8a07503fffff",60,103,163
"4173",1970-01-01 15:30:00,"88a8a07507fffff",270,602,872
"4174",1970-01-01 15:30:00,"88a8a07515fffff",240,412,652
"4175",1970-01-01 15:30:00,"88a8a0751dfffff",60,103,163
"4176",1970-01-01 15:30:00,"88a8a07521fffff",381,855,1236
"4177",1970-01-01 15:30:00,"88a8a07525fffff",270,602,872
"4178",1970-01-01 15:30:00,"88a8a0752bfffff",501,1061,1562
"4179",1970-01-01 15:30:00,"88a8a0752dfffff",330,705,1035
"4180",1970-01-01 15:30:00,"88a8a07531fffff",441,958,1399
"4181",1970-01-01 15:30:00,"88a8a07533fffff",120,206,326
"4182",1970-01-01 15:30:00,"88a8a07535fffff",150,396,546
"4183",1970-01-01 15:30:00,"88a8a07537fffff",120,206,326
"4184",1970-01-01 15:30:00,"88a8a07539fffff",459,864,1323
"4185",1970-01-01 15:30:00,"88a8a0753dfffff",162,403,565
"4186",1970-01-01 15:30:00,"88a8a07543fffff",495,932,1427
"4187",1970-01-01 15:30:00,"88a8a07545fffff",300,515,815
"4188",1970-01-01 15:30:00,"88a8a07547fffff",411,768,1179
"4189",1970-01-01 15:30:00,"88a8a07553fffff",60,103,163
"4190",1970-01-01 15:30:00,"88a8a07557fffff",60,103,163
"4191",1970-01-01 15:30:00,"88a8a07559fffff",513,953,1466
"4192",1970-01-01 15:30:00,"88a8a0755bfffff",60,103,163
"4193",1970-01-01 15:30:00,"88a8a0755dfffff",555,1035,1590
"4194",1970-01-01 15:30:00,"88a8a07561fffff",266,702,968
"4195",1970-01-01 15:30:00,"88a8a07565fffff",0,0,0
"4196",1970-01-01 15:30:00,"88a8a07567fffff",485,1154,1639
"4197",1970-01-01 15:30:00,"88a8a07569fffff",453,850,1303
"4198",1970-01-01 15:30:00,"88a8a0756bfffff",213,438,651
"4199",1970-01-01 15:30:00,"88a8a0756dfffff",384,794,1178
"4200",1970-01-01 15:30:00,"88a8a07633fffff",284,608,892
"4201",1970-01-01 15:30:00,"88a8a07637fffff",284,608,892
"4202",1970-01-01 15:30:00,"88a8a076c7fffff",215,552,767
"4203",1970-01-01 15:30:00,"88a8a076d1fffff",104,299,403
"4204",1970-01-01 15:30:00,"88a8a076d3fffff",277,654,931
"4205",1970-01-01 15:30:00,"88a8a076d5fffff",104,299,403
"4206",1970-01-01 15:30:00,"88a8a076d7fffff",60,103,163
"4207",1970-01-01 15:30:00,"88a8a076e9fffff",231,459,690
"4208",1970-01-01 15:30:00,"88a8a076ebfffff",224,505,729
"4209",1970-01-01 15:30:00,"88a8a076edfffff",284,608,892
"4210",1970-01-01 16:00:00,"88a8a02801fffff",134,280,414
"4211",1970-01-01 16:00:00,"88a8a02805fffff",33,60,93
"4212",1970-01-01 16:00:00,"88a8a02809fffff",0,0,0
"4213",1970-01-01 16:00:00,"88a8a0280bfffff",134,280,414
"4214",1970-01-01 16:00:00,"88a8a02829fffff",33,60,93
"4215",1970-01-01 16:00:00,"88a8a02853fffff",81,131,212
"4216",1970-01-01 16:00:00,"88a8a02857fffff",134,280,414
"4217",1970-01-01 16:00:00,"88a8a02a01fffff",155,449,604
"4218",1970-01-01 16:00:00,"88a8a02a05fffff",102,300,402
"4219",1970-01-01 16:00:00,"88a8a02a0bfffff",102,300,402
"4220",1970-01-01 16:00:00,"88a8a02a11fffff",150,371,521
"4221",1970-01-01 16:00:00,"88a8a02a13fffff",150,371,521
"4222",1970-01-01 16:00:00,"88a8a02a19fffff",99,221,320
"4223",1970-01-01 16:00:00,"88a8a02a57fffff",99,221,320
"4224",1970-01-01 16:00:00,"88a8a02a61fffff",60,103,163
"4225",1970-01-01 16:00:00,"88a8a02a63fffff",102,300,402
"4226",1970-01-01 16:00:00,"88a8a02a69fffff",162,403,565
"4227",1970-01-01 16:00:00,"88a8a02a89fffff",86,209,295
"4228",1970-01-01 16:00:00,"88a8a02a8bfffff",155,449,604
"4229",1970-01-01 16:00:00,"88a8a02a9dfffff",104,299,403
"4230",1970-01-01 16:00:00,"88a8a02aa9fffff",0,0,0
"4231",1970-01-01 16:00:00,"88a8a02aadfffff",81,131,212
"4232",1970-01-01 16:00:00,"88a8a02ac5fffff",152,370,522
"4233",1970-01-01 16:00:00,"88a8a02ac7fffff",185,430,615
"4234",1970-01-01 16:00:00,"88a8a02ae3fffff",81,131,212
"4235",1970-01-01 16:00:00,"88a8a02ae7fffff",81,131,212
"4236",1970-01-01 16:00:00,"88a8a02aebfffff",48,71,119
"4237",1970-01-01 16:00:00,"88a8a03987fffff",60,103,163
"4238",1970-01-01 16:00:00,"88a8a03995fffff",240,412,652
"4239",1970-01-01 16:00:00,"88a8a03997fffff",162,403,565
"4240",1970-01-01 16:00:00,"88a8a039a1fffff",342,712,1054
"4241",1970-01-01 16:00:00,"88a8a039abfffff",393,862,1255
"4242",1970-01-01 16:00:00,"88a8a039adfffff",513,1068,1581
"4243",1970-01-01 16:00:00,"88a8a039b9fffff",291,562,853
"4244",1970-01-01 16:00:00,"88a8a039bbfffff",282,609,891
"4245",1970-01-01 16:00:00,"88a8a039bdfffff",171,356,527
"4246",1970-01-01 16:00:00,"88a8a06085fffff",219,452,671
"4247",1970-01-01 16:00:00,"88a8a0608dfffff",378,801,1179
"4248",1970-01-01 16:00:00,"88a8a060a3fffff",171,356,527
"4249",1970-01-01 16:00:00,"88a8a060a7fffff",60,103,163
"4250",1970-01-01 16:00:00,"88a8a060abfffff",171,356,527
"4251",1970-01-01 16:00:00,"88a8a060c1fffff",0,0,0
"4252",1970-01-01 16:00:00,"88a8a060c3fffff",267,548,815
"4253",1970-01-01 16:00:00,"88a8a060c7fffff",267,548,815
"4254",1970-01-01 16:00:00,"88a8a060cbfffff",369,848,1217
"4255",1970-01-01 16:00:00,"88a8a06193fffff",162,403,565
"4256",1970-01-01 16:00:00,"88a8a06197fffff",213,438,651
"4257",1970-01-01 16:00:00,"88a8a0619bfffff",60,103,163
"4258",1970-01-01 16:00:00,"88a8a061a1fffff",102,300,402
"4259",1970-01-01 16:00:00,"88a8a061a3fffff",102,300,402
"4260",1970-01-01 16:00:00,"88a8a061a5fffff",51,150,201
"4261",1970-01-01 16:00:00,"88a8a061b1fffff",213,438,651
"4262",1970-01-01 16:00:00,"88a8a061b3fffff",213,438,651
"4263",1970-01-01 16:00:00,"88a8a061b5fffff",111,253,364
"4264",1970-01-01 16:00:00,"88a8a061b7fffff",333,644,977
"4265",1970-01-01 16:00:00,"88a8a06249fffff",180,309,489
"4266",1970-01-01 16:00:00,"88a8a0624bfffff",240,412,652
"4267",1970-01-01 16:00:00,"88a8a0624dfffff",293,561,854
"4268",1970-01-01 16:00:00,"88a8a06281fffff",104,299,403
"4269",1970-01-01 16:00:00,"88a8a06283fffff",219,452,671
"4270",1970-01-01 16:00:00,"88a8a06287fffff",318,698,1016
"4271",1970-01-01 16:00:00,"88a8a06289fffff",323,751,1074
"4272",1970-01-01 16:00:00,"88a8a0628bfffff",219,452,671
"4273",1970-01-01 16:00:00,"88a8a06293fffff",120,206,326
"4274",1970-01-01 16:00:00,"88a8a06299fffff",120,206,326
"4275",1970-01-01 16:00:00,"88a8a0629bfffff",180,309,489
"4276",1970-01-01 16:00:00,"88a8a062b5fffff",210,499,709
"4277",1970-01-01 16:00:00,"88a8a062bdfffff",318,698,1016
"4278",1970-01-01 16:00:00,"88a8a062c1fffff",212,498,710
"4279",1970-01-01 16:00:00,"88a8a062c3fffff",371,847,1218
"4280",1970-01-01 16:00:00,"88a8a062cbfffff",380,800,1180
"4281",1970-01-01 16:00:00,"88a8a062d1fffff",360,618,978
"4282",1970-01-01 16:00:00,"88a8a062d3fffff",300,515,815
"4283",1970-01-01 16:00:00,"88a8a062d9fffff",240,412,652
"4284",1970-01-01 16:00:00,"88a8a06541fffff",60,103,163
"4285",1970-01-01 16:00:00,"88a8a06549fffff",120,206,326
"4286",1970-01-01 16:00:00,"88a8a06705fffff",180,309,489
"4287",1970-01-01 16:00:00,"88a8a06707fffff",120,206,326
"4288",1970-01-01 16:00:00,"88a8a0670dfffff",120,206,326
"4289",1970-01-01 16:00:00,"88a8a06731fffff",60,103,163
"4290",1970-01-01 16:00:00,"88a8a06735fffff",120,206,326
"4291",1970-01-01 16:00:00,"88a8a06739fffff",180,309,489
"4292",1970-01-01 16:00:00,"88a8a0674dfffff",60,103,163
"4293",1970-01-01 16:00:00,"88a8a0676bfffff",240,412,652
"4294",1970-01-01 16:00:00,"88a8a06a91fffff",51,150,201
"4295",1970-01-01 16:00:00,"88a8a06a9bfffff",51,150,201
"4296",1970-01-01 16:00:00,"88a8a06e49fffff",171,356,527
"4297",1970-01-01 16:00:00,"88a8a06e4dfffff",222,506,728
"4298",1970-01-01 16:00:00,"88a8a06e6dfffff",213,438,651
"4299",1970-01-01 16:00:00,"88a8a06f05fffff",51,150,201
"4300",1970-01-01 16:00:00,"88a8a06f61fffff",102,300,402
"4301",1970-01-01 16:00:00,"88a8a06f63fffff",102,300,402
"4302",1970-01-01 16:00:00,"88a8a06f67fffff",102,300,402
"4303",1970-01-01 16:00:00,"88a8a06f69fffff",102,300,402
"4304",1970-01-01 16:00:00,"88a8a070b3fffff",360,618,978
"4305",1970-01-01 16:00:00,"88a8a070b7fffff",360,618,978
"4306",1970-01-01 16:00:00,"88a8a0719bfffff",286,607,893
"4307",1970-01-01 16:00:00,"88a8a07441fffff",324,691,1015
"4308",1970-01-01 16:00:00,"88a8a07445fffff",306,670,976
"4309",1970-01-01 16:00:00,"88a8a07447fffff",153,335,488
"4310",1970-01-01 16:00:00,"88a8a0744bfffff",153,335,488
"4311",1970-01-01 16:00:00,"88a8a07461fffff",759,1520,2279
"4312",1970-01-01 16:00:00,"88a8a07465fffff",641,1313,1954
"4313",1970-01-01 16:00:00,"88a8a07467fffff",120,206,326
"4314",1970-01-01 16:00:00,"88a8a07469fffff",60,103,163
"4315",1970-01-01 16:00:00,"88a8a0746bfffff",597,1232,1829
"4316",1970-01-01 16:00:00,"88a8a07503fffff",60,103,163
"4317",1970-01-01 16:00:00,"88a8a07507fffff",635,1273,1908
"4318",1970-01-01 16:00:00,"88a8a07515fffff",600,1030,1630
"4319",1970-01-01 16:00:00,"88a8a0751dfffff",120,206,326
"4320",1970-01-01 16:00:00,"88a8a07521fffff",752,1425,2177
"4321",1970-01-01 16:00:00,"88a8a07525fffff",360,618,978
"4322",1970-01-01 16:00:00,"88a8a0752bfffff",752,1425,2177
"4323",1970-01-01 16:00:00,"88a8a0752dfffff",692,1322,2014
"4324",1970-01-01 16:00:00,"88a8a07531fffff",1031,1980,3011
"4325",1970-01-01 16:00:00,"88a8a07533fffff",240,412,652
"4326",1970-01-01 16:00:00,"88a8a07535fffff",431,950,1381
"4327",1970-01-01 16:00:00,"88a8a07537fffff",420,721,1141
"4328",1970-01-01 16:00:00,"88a8a07539fffff",932,1734,2666
"4329",1970-01-01 16:00:00,"88a8a0753bfffff",60,103,163
"4330",1970-01-01 16:00:00,"88a8a0753dfffff",339,658,997
"4331",1970-01-01 16:00:00,"88a8a07543fffff",527,1211,1738
"4332",1970-01-01 16:00:00,"88a8a07545fffff",393,862,1255
"4333",1970-01-01 16:00:00,"88a8a07547fffff",527,1211,1738
"4334",1970-01-01 16:00:00,"88a8a07553fffff",180,309,489
"4335",1970-01-01 16:00:00,"88a8a07557fffff",180,309,489
"4336",1970-01-01 16:00:00,"88a8a07559fffff",479,1140,1619
"4337",1970-01-01 16:00:00,"88a8a0755bfffff",180,309,489
"4338",1970-01-01 16:00:00,"88a8a0755dfffff",527,1211,1738
"4339",1970-01-01 16:00:00,"88a8a07561fffff",852,1726,2578
"4340",1970-01-01 16:00:00,"88a8a07565fffff",108,199,307
"4341",1970-01-01 16:00:00,"88a8a07567fffff",687,1269,1956
"4342",1970-01-01 16:00:00,"88a8a07569fffff",647,1417,2064
"4343",1970-01-01 16:00:00,"88a8a0756bfffff",425,911,1336
"4344",1970-01-01 16:00:00,"88a8a0756dfffff",1034,2009,3043
"4345",1970-01-01 16:00:00,"88a8a07633fffff",261,509,770
"4346",1970-01-01 16:00:00,"88a8a07637fffff",102,185,287
"4347",1970-01-01 16:00:00,"88a8a076c7fffff",111,253,364
"4348",1970-01-01 16:00:00,"88a8a076d1fffff",240,412,652
"4349",1970-01-01 16:00:00,"88a8a076d3fffff",513,1068,1581
"4350",1970-01-01 16:00:00,"88a8a076d5fffff",222,506,728
"4351",1970-01-01 16:00:00,"88a8a076d7fffff",171,356,527
"4352",1970-01-01 16:00:00,"88a8a076e9fffff",111,253,364
"4353",1970-01-01 16:00:00,"88a8a076ebfffff",111,253,364
"4354",1970-01-01 16:00:00,"88a8a076edfffff",111,253,364
"4355",1970-01-01 16:30:00,"88a8a02801fffff",102,300,402
"4356",1970-01-01 16:30:00,"88a8a02809fffff",0,0,0
"4357",1970-01-01 16:30:00,"88a8a0280bfffff",102,300,402
"4358",1970-01-01 16:30:00,"88a8a02825fffff",33,60,93
"4359",1970-01-01 16:30:00,"88a8a02829fffff",33,60,93
"4360",1970-01-01 16:30:00,"88a8a0282dfffff",66,120,186
"4361",1970-01-01 16:30:00,"88a8a02853fffff",104,299,403
"4362",1970-01-01 16:30:00,"88a8a02857fffff",51,150,201
"4363",1970-01-01 16:30:00,"88a8a02919fffff",33,60,93
"4364",1970-01-01 16:30:00,"88a8a0291dfffff",33,60,93
"4365",1970-01-01 16:30:00,"88a8a02953fffff",33,60,93
"4366",1970-01-01 16:30:00,"88a8a02957fffff",33,60,93
"4367",1970-01-01 16:30:00,"88a8a02a01fffff",204,485,689
"4368",1970-01-01 16:30:00,"88a8a02a05fffff",252,556,808
"4369",1970-01-01 16:30:00,"88a8a02a09fffff",53,149,202
"4370",1970-01-01 16:30:00,"88a8a02a0bfffff",164,402,566
"4371",1970-01-01 16:30:00,"88a8a02a11fffff",113,252,365
"4372",1970-01-01 16:30:00,"88a8a02a13fffff",215,552,767
"4373",1970-01-01 16:30:00,"88a8a02a19fffff",217,551,768
"4374",1970-01-01 16:30:00,"88a8a02a57fffff",217,551,768
"4375",1970-01-01 16:30:00,"88a8a02a61fffff",93,232,325
"4376",1970-01-01 16:30:00,"88a8a02a63fffff",350,866,1216
"4377",1970-01-01 16:30:00,"88a8a02a69fffff",290,763,1053
"4378",1970-01-01 16:30:00,"88a8a02a6bfffff",104,299,403
"4379",1970-01-01 16:30:00,"88a8a02a89fffff",317,852,1169
"4380",1970-01-01 16:30:00,"88a8a02a8bfffff",215,552,767
"4381",1970-01-01 16:30:00,"88a8a02a9dfffff",111,253,364
"4382",1970-01-01 16:30:00,"88a8a02aadfffff",104,299,403
"4383",1970-01-01 16:30:00,"88a8a02ac5fffff",266,702,968
"4384",1970-01-01 16:30:00,"88a8a02ac7fffff",319,851,1170
"4385",1970-01-01 16:30:00,"88a8a02ae3fffff",53,149,202
"4386",1970-01-01 16:30:00,"88a8a02aebfffff",53,149,202
"4387",1970-01-01 16:30:00,"88a8a03987fffff",324,691,1015
"4388",1970-01-01 16:30:00,"88a8a03995fffff",173,355,528
"4389",1970-01-01 16:30:00,"88a8a03997fffff",290,763,1053
"4390",1970-01-01 16:30:00,"88a8a039a1fffff",357,820,1177
"4391",1970-01-01 16:30:00,"88a8a039abfffff",477,1026,1503
"4392",1970-01-01 16:30:00,"88a8a039adfffff",423,912,1335
"4393",1970-01-01 16:30:00,"88a8a039b9fffff",530,1175,1705
"4394",1970-01-01 16:30:00,"88a8a039bbfffff",417,923,1340
"4395",1970-01-01 16:30:00,"88a8a039bdfffff",42,82,124
"4396",1970-01-01 16:30:00,"88a8a06085fffff",254,580,834
"4397",1970-01-01 16:30:00,"88a8a0608dfffff",416,983,1399
"4398",1970-01-01 16:30:00,"88a8a060a3fffff",153,335,488
"4399",1970-01-01 16:30:00,"88a8a060abfffff",53,149,202
"4400",1970-01-01 16:30:00,"88a8a060c3fffff",455,1126,1581
"4401",1970-01-01 16:30:00,"88a8a060c7fffff",518,1283,1801
"4402",1970-01-01 16:30:00,"88a8a060cbfffff",674,1578,2252
"4403",1970-01-01 16:30:00,"88a8a06193fffff",308,784,1092
"4404",1970-01-01 16:30:00,"88a8a06197fffff",215,552,767
"4405",1970-01-01 16:30:00,"88a8a0619bfffff",53,149,202
"4406",1970-01-01 16:30:00,"88a8a061a1fffff",150,384,534
"4407",1970-01-01 16:30:00,"88a8a061a3fffff",51,150,201
"4408",1970-01-01 16:30:00,"88a8a061a5fffff",150,384,534
"4409",1970-01-01 16:30:00,"88a8a061b1fffff",162,403,565
"4410",1970-01-01 16:30:00,"88a8a061b3fffff",215,552,767
"4411",1970-01-01 16:30:00,"88a8a061b5fffff",102,300,402
"4412",1970-01-01 16:30:00,"88a8a061b7fffff",213,553,766
"4413",1970-01-01 16:30:00,"88a8a06249fffff",875,1685,2560
"4414",1970-01-01 16:30:00,"88a8a0624bfffff",815,1582,2397
"4415",1970-01-01 16:30:00,"88a8a0624dfffff",926,1835,2761
"4416",1970-01-01 16:30:00,"88a8a06281fffff",312,684,996
"4417",1970-01-01 16:30:00,"88a8a06283fffff",836,1981,2817
"4418",1970-01-01 16:30:00,"88a8a06287fffff",626,1482,2108
"4419",1970-01-01 16:30:00,"88a8a06289fffff",639,1450,2089
"4420",1970-01-01 16:30:00,"88a8a0628bfffff",273,656,929
"4421",1970-01-01 16:30:00,"88a8a06293fffff",240,412,652
"4422",1970-01-01 16:30:00,"88a8a06299fffff",180,309,489
"4423",1970-01-01 16:30:00,"88a8a0629bfffff",240,412,652
"4424",1970-01-01 16:30:00,"88a8a062b5fffff",674,1578,2252
"4425",1970-01-01 16:30:00,"88a8a062bdfffff",725,1728,2453
"4426",1970-01-01 16:30:00,"88a8a062c1fffff",330,705,1035
"4427",1970-01-01 16:30:00,"88a8a062c3fffff",471,1148,1619
"4428",1970-01-01 16:30:00,"88a8a062cbfffff",372,902,1274
"4429",1970-01-01 16:30:00,"88a8a062d1fffff",180,309,489
"4430",1970-01-01 16:30:00,"88a8a062d3fffff",240,412,652
"4431",1970-01-01 16:30:00,"88a8a062d9fffff",240,412,652
"4432",1970-01-01 16:30:00,"88a8a06541fffff",120,206,326
"4433",1970-01-01 16:30:00,"88a8a06549fffff",240,412,652
"4434",1970-01-01 16:30:00,"88a8a06705fffff",240,412,652
"4435",1970-01-01 16:30:00,"88a8a06707fffff",180,309,489
"4436",1970-01-01 16:30:00,"88a8a0670dfffff",60,103,163
"4437",1970-01-01 16:30:00,"88a8a06731fffff",240,412,652
"4438",1970-01-01 16:30:00,"88a8a06735fffff",240,412,652
"4439",1970-01-01 16:30:00,"88a8a06739fffff",180,309,489
"4440",1970-01-01 16:30:00,"88a8a0673dfffff",60,103,163
"4441",1970-01-01 16:30:00,"88a8a0674dfffff",300,515,815
"4442",1970-01-01 16:30:00,"88a8a0676bfffff",120,206,326
"4443",1970-01-01 16:30:00,"88a8a06a91fffff",150,384,534
"4444",1970-01-01 16:30:00,"88a8a06a9bfffff",153,450,603
"4445",1970-01-01 16:30:00,"88a8a06e49fffff",111,253,364
"4446",1970-01-01 16:30:00,"88a8a06e4dfffff",257,634,891
"4447",1970-01-01 16:30:00,"88a8a06e69fffff",51,150,201
"4448",1970-01-01 16:30:00,"88a8a06e6dfffff",215,552,767
"4449",1970-01-01 16:30:00,"88a8a06f05fffff",51,150,201
"4450",1970-01-01 16:30:00,"88a8a06f61fffff",102,300,402
"4451",1970-01-01 16:30:00,"88a8a06f63fffff",51,150,201
"4452",1970-01-01 16:30:00,"88a8a06f67fffff",51,150,201
"4453",1970-01-01 16:30:00,"88a8a06f69fffff",102,300,402
"4454",1970-01-01 16:30:00,"88a8a070b3fffff",815,1582,2397
"4455",1970-01-01 16:30:00,"88a8a070b7fffff",815,1582,2397
"4456",1970-01-01 16:30:00,"88a8a0719bfffff",402,815,1217
"4457",1970-01-01 16:30:00,"88a8a07441fffff",444,897,1341
"4458",1970-01-01 16:30:00,"88a8a07443fffff",51,150,201
"4459",1970-01-01 16:30:00,"88a8a07445fffff",120,206,326
"4460",1970-01-01 16:30:00,"88a8a07447fffff",231,459,690
"4461",1970-01-01 16:30:00,"88a8a0744bfffff",504,1000,1504
"4462",1970-01-01 16:30:00,"88a8a07461fffff",837,1615,2452
"4463",1970-01-01 16:30:00,"88a8a07465fffff",669,1313,1982
"4464",1970-01-01 16:30:00,"88a8a07467fffff",99,246,345
"4465",1970-01-01 16:30:00,"88a8a07469fffff",108,199,307
"4466",1970-01-01 16:30:00,"88a8a0746bfffff",558,1085,1643
"4467",1970-01-01 16:30:00,"88a8a07503fffff",60,103,163
"4468",1970-01-01 16:30:00,"88a8a07507fffff",633,1274,1907
"4469",1970-01-01 16:30:00,"88a8a07515fffff",348,611,959
"4470",1970-01-01 16:30:00,"88a8a0751dfffff",159,349,508
"4471",1970-01-01 16:30:00,"88a8a07521fffff",1065,2164,3229
"4472",1970-01-01 16:30:00,"88a8a07525fffff",582,1124,1706
"4473",1970-01-01 16:30:00,"88a8a0752bfffff",1065,2164,3229
"4474",1970-01-01 16:30:00,"88a8a0752dfffff",903,1876,2779
"4475",1970-01-01 16:30:00,"88a8a07531fffff",1011,2075,3086
"4476",1970-01-01 16:30:00,"88a8a07533fffff",60,103,163
"4477",1970-01-01 16:30:00,"88a8a07535fffff",582,1401,1983
"4478",1970-01-01 16:30:00,"88a8a07537fffff",120,206,326
"4479",1970-01-01 16:30:00,"88a8a07539fffff",1077,2077,3154
"4480",1970-01-01 16:30:00,"88a8a0753bfffff",60,103,163
"4481",1970-01-01 16:30:00,"88a8a0753dfffff",261,649,910
"4482",1970-01-01 16:30:00,"88a8a07543fffff",633,1274,1907
"4483",1970-01-01 16:30:00,"88a8a07545fffff",471,871,1342
"4484",1970-01-01 16:30:00,"88a8a07547fffff",744,1527,2271
"4485",1970-01-01 16:30:00,"88a8a07553fffff",159,349,508
"4486",1970-01-01 16:30:00,"88a8a07557fffff",111,253,364
"4487",1970-01-01 16:30:00,"88a8a07559fffff",621,1242,1863
"4488",1970-01-01 16:30:00,"88a8a0755bfffff",159,349,508
"4489",1970-01-01 16:30:00,"88a8a0755dfffff",684,1424,2108
"4490",1970-01-01 16:30:00,"88a8a07561fffff",741,1358,2099
"4491",1970-01-01 16:30:00,"88a8a07565fffff",231,459,690
"4492",1970-01-01 16:30:00,"88a8a07567fffff",957,1965,2922
"4493",1970-01-01 16:30:00,"88a8a07569fffff",855,1780,2635
"4494",1970-01-01 16:30:00,"88a8a0756bfffff",615,1368,1983
"4495",1970-01-01 16:30:00,"88a8a0756dfffff",1095,2192,3287
"4496",1970-01-01 16:30:00,"88a8a07633fffff",504,1000,1504
"4497",1970-01-01 16:30:00,"88a8a07637fffff",504,1000,1504
"4498",1970-01-01 16:30:00,"88a8a076c7fffff",111,253,364
"4499",1970-01-01 16:30:00,"88a8a076d1fffff",228,380,608
"4500",1970-01-01 16:30:00,"88a8a076d3fffff",432,865,1297
"4501",1970-01-01 16:30:00,"88a8a076d5fffff",219,427,646
"4502",1970-01-01 16:30:00,"88a8a076d7fffff",201,406,607
"4503",1970-01-01 16:30:00,"88a8a076e9fffff",246,567,813
"4504",1970-01-01 16:30:00,"88a8a076ebfffff",246,567,813
"4505",1970-01-01 16:30:00,"88a8a076edfffff",306,670,976
"4506",1970-01-01 17:00:00,"88a8a02801fffff",84,210,294
"4507",1970-01-01 17:00:00,"88a8a02805fffff",33,60,93
"4508",1970-01-01 17:00:00,"88a8a02809fffff",0,0,0
"4509",1970-01-01 17:00:00,"88a8a0280bfffff",33,60,93
"4510",1970-01-01 17:00:00,"88a8a02853fffff",84,210,294
"4511",1970-01-01 17:00:00,"88a8a02857fffff",84,210,294
"4512",1970-01-01 17:00:00,"88a8a02a01fffff",414,959,1373
"4513",1970-01-01 17:00:00,"88a8a02a05fffff",363,809,1172
"4514",1970-01-01 17:00:00,"88a8a02a09fffff",42,82,124
"4515",1970-01-01 17:00:00,"88a8a02a0bfffff",162,403,565
"4516",1970-01-01 17:00:00,"88a8a02a0dfffff",192,453,645
"4517",1970-01-01 17:00:00,"88a8a02a11fffff",162,403,565
"4518",1970-01-01 17:00:00,"88a8a02a13fffff",111,253,364
"4519",1970-01-01 17:00:00,"88a8a02a19fffff",321,727,1048
"4520",1970-01-01 17:00:00,"88a8a02a57fffff",324,806,1130
"4521",1970-01-01 17:00:00,"88a8a02a61fffff",162,403,565
"4522",1970-01-01 17:00:00,"88a8a02a63fffff",264,588,852
"4523",1970-01-01 17:00:00,"88a8a02a69fffff",375,841,1216
"4524",1970-01-01 17:00:00,"88a8a02a6bfffff",51,150,201
"4525",1970-01-01 17:00:00,"88a8a02a89fffff",135,245,380
"4526",1970-01-01 17:00:00,"88a8a02a8bfffff",237,545,782
"4527",1970-01-01 17:00:00,"88a8a02a9dfffff",126,292,418
"4528",1970-01-01 17:00:00,"88a8a02aadfffff",84,210,294
"4529",1970-01-01 17:00:00,"88a8a02ac5fffff",257,634,891
"4530",1970-01-01 17:00:00,"88a8a02ac7fffff",290,694,984
"4531",1970-01-01 17:00:00,"88a8a02ae3fffff",135,360,495
"4532",1970-01-01 17:00:00,"88a8a02ae7fffff",135,360,495
"4533",1970-01-01 17:00:00,"88a8a02aebfffff",188,509,697
"4534",1970-01-01 17:00:00,"88a8a03987fffff",255,635,890
"4535",1970-01-01 17:00:00,"88a8a03995fffff",180,309,489
"4536",1970-01-01 17:00:00,"88a8a03997fffff",426,991,1417
"4537",1970-01-01 17:00:00,"88a8a039a1fffff",717,1553,2270
"4538",1970-01-01 17:00:00,"88a8a039abfffff",597,1347,1944
"4539",1970-01-01 17:00:00,"88a8a039adfffff",763,1748,2511
"4540",1970-01-01 17:00:00,"88a8a039b9fffff",486,1094,1580
"4541",1970-01-01 17:00:00,"88a8a039bbfffff",528,1291,1819
"4542",1970-01-01 17:00:00,"88a8a039bdfffff",60,103,163
"4543",1970-01-01 17:00:00,"88a8a06081fffff",216,398,614
"4544",1970-01-01 17:00:00,"88a8a06085fffff",471,1136,1607
"4545",1970-01-01 17:00:00,"88a8a0608dfffff",896,2084,2980
"4546",1970-01-01 17:00:00,"88a8a060a3fffff",252,684,936
"4547",1970-01-01 17:00:00,"88a8a060abfffff",150,384,534
"4548",1970-01-01 17:00:00,"88a8a060c1fffff",210,499,709
"4549",1970-01-01 17:00:00,"88a8a060c3fffff",570,1279,1849
"4550",1970-01-01 17:00:00,"88a8a060c7fffff",480,1101,1581
"4551",1970-01-01 17:00:00,"88a8a060cbfffff",411,930,1341
"4552",1970-01-01 17:00:00,"88a8a06193fffff",354,984,1338
"4553",1970-01-01 17:00:00,"88a8a06197fffff",303,834,1137
"4554",1970-01-01 17:00:00,"88a8a061a1fffff",104,299,403
"4555",1970-01-01 17:00:00,"88a8a061a3fffff",203,533,736
"4556",1970-01-01 17:00:00,"88a8a061a5fffff",104,299,403
"4557",1970-01-01 17:00:00,"88a8a061b1fffff",305,833,1138
"4558",1970-01-01 17:00:00,"88a8a061b3fffff",303,834,1137
"4559",1970-01-01 17:00:00,"88a8a061b5fffff",203,533,736
"4560",1970-01-01 17:00:00,"88a8a061b7fffff",404,1067,1471
"4561",1970-01-01 17:00:00,"88a8a06249fffff",411,768,1179
"4562",1970-01-01 17:00:00,"88a8a0624bfffff",471,871,1342
"4563",1970-01-01 17:00:00,"88a8a0624dfffff",531,974,1505
"4564",1970-01-01 17:00:00,"88a8a06281fffff",159,349,508
"4565",1970-01-01 17:00:00,"88a8a06283fffff",411,930,1341
"4566",1970-01-01 17:00:00,"88a8a06287fffff",321,637,958
"4567",1970-01-01 17:00:00,"88a8a06289fffff",554,1257,1811
"4568",1970-01-01 17:00:00,"88a8a0628bfffff",111,253,364
"4569",1970-01-01 17:00:00,"88a8a06293fffff",60,103,163
"4570",1970-01-01 17:00:00,"88a8a06299fffff",180,309,489
"4571",1970-01-01 17:00:00,"88a8a0629bfffff",120,206,326
"4572",1970-01-01 17:00:00,"88a8a062b5fffff",309,630,939
"4573",1970-01-01 17:00:00,"88a8a062bdfffff",471,1033,1504
"4574",1970-01-01 17:00:00,"88a8a062c1fffff",204,485,689
"4575",1970-01-01 17:00:00,"88a8a062c3fffff",503,1107,1610
"4576",1970-01-01 17:00:00,"88a8a062cbfffff",452,957,1409
"4577",1970-01-01 17:00:00,"88a8a062d1fffff",240,412,652
"4578",1970-01-01 17:00:00,"88a8a062d3fffff",240,412,652
"4579",1970-01-01 17:00:00,"88a8a062d9fffff",240,412,652
"4580",1970-01-01 17:00:00,"88a8a06541fffff",120,206,326
"4581",1970-01-01 17:00:00,"88a8a06549fffff",180,309,489
"4582",1970-01-01 17:00:00,"88a8a06705fffff",360,618,978
"4583",1970-01-01 17:00:00,"88a8a06707fffff",120,206,326
"4584",1970-01-01 17:00:00,"88a8a0670dfffff",120,206,326
"4585",1970-01-01 17:00:00,"88a8a0672bfffff",120,206,326
"4586",1970-01-01 17:00:00,"88a8a06731fffff",180,309,489
"4587",1970-01-01 17:00:00,"88a8a06735fffff",180,309,489
"4588",1970-01-01 17:00:00,"88a8a06739fffff",240,412,652
"4589",1970-01-01 17:00:00,"88a8a0674dfffff",120,206,326
"4590",1970-01-01 17:00:00,"88a8a0676bfffff",240,412,652
"4591",1970-01-01 17:00:00,"88a8a06a91fffff",51,150,201
"4592",1970-01-01 17:00:00,"88a8a06a9bfffff",102,300,402
"4593",1970-01-01 17:00:00,"88a8a06e49fffff",252,684,936
"4594",1970-01-01 17:00:00,"88a8a06e4dfffff",201,534,735
"4595",1970-01-01 17:00:00,"88a8a06e69fffff",51,150,201
"4596",1970-01-01 17:00:00,"88a8a06e6dfffff",303,834,1137
"4597",1970-01-01 17:00:00,"88a8a070b3fffff",420,721,1141
"4598",1970-01-01 17:00:00,"88a8a070b7fffff",471,871,1342
"4599",1970-01-01 17:00:00,"88a8a0719bfffff",420,721,1141
"4600",1970-01-01 17:00:00,"88a8a07441fffff",827,1841,2668
"4601",1970-01-01 17:00:00,"88a8a07443fffff",51,150,201
"4602",1970-01-01 17:00:00,"88a8a07445fffff",727,1540,2267
"4603",1970-01-01 17:00:00,"88a8a07447fffff",610,1413,2023
"4604",1970-01-01 17:00:00,"88a8a0744bfffff",880,1990,2870
"4605",1970-01-01 17:00:00,"88a8a07461fffff",1033,2181,3214
"4606",1970-01-01 17:00:00,"88a8a07465fffff",838,1793,2631
"4607",1970-01-01 17:00:00,"88a8a07467fffff",168,302,470
"4608",1970-01-01 17:00:00,"88a8a07469fffff",219,452,671
"4609",1970-01-01 17:00:00,"88a8a0746bfffff",1042,2134,3176
"4610",1970-01-01 17:00:00,"88a8a07503fffff",120,206,326
"4611",1970-01-01 17:00:00,"88a8a07507fffff",839,1643,2482
"4612",1970-01-01 17:00:00,"88a8a07515fffff",690,1208,1898
"4613",1970-01-01 17:00:00,"88a8a0751dfffff",210,384,594
"4614",1970-01-01 17:00:00,"88a8a07521fffff",827,1636,2463
"4615",1970-01-01 17:00:00,"88a8a07525fffff",342,597,939
"4616",1970-01-01 17:00:00,"88a8a0752bfffff",878,1786,2664
"4617",1970-01-01 17:00:00,"88a8a0752dfffff",827,1636,2463
"4618",1970-01-01 17:00:00,"88a8a07531fffff",1256,2472,3728
"4619",1970-01-01 17:00:00,"88a8a07533fffff",300,515,815
"4620",1970-01-01 17:00:00,"88a8a07535fffff",353,826,1179
"4621",1970-01-01 17:00:00,"88a8a07537fffff",180,309,489
"4622",1970-01-01 17:00:00,"88a8a07539fffff",1227,2337,3564
"4623",1970-01-01 17:00:00,"88a8a0753bfffff",120,206,326
"4624",1970-01-01 17:00:00,"88a8a0753dfffff",423,822,1245
"4625",1970-01-01 17:00:00,"88a8a07543fffff",815,1582,2397
"4626",1970-01-01 17:00:00,"88a8a07545fffff",471,871,1342
"4627",1970-01-01 17:00:00,"88a8a07547fffff",644,1226,1870
"4628",1970-01-01 17:00:00,"88a8a07553fffff",168,302,470
"4629",1970-01-01 17:00:00,"88a8a07557fffff",150,281,431
"4630",1970-01-01 17:00:00,"88a8a07559fffff",746,1526,2272
"4631",1970-01-01 17:00:00,"88a8a0755bfffff",168,302,470
"4632",1970-01-01 17:00:00,"88a8a0755dfffff",755,1479,2234
"4633",1970-01-01 17:00:00,"88a8a07561fffff",1007,1945,2952
"4634",1970-01-01 17:00:00,"88a8a07565fffff",171,356,527
"4635",1970-01-01 17:00:00,"88a8a07567fffff",887,1739,2626
"4636",1970-01-01 17:00:00,"88a8a07569fffff",582,1124,1706
"4637",1970-01-01 17:00:00,"88a8a0756bfffff",411,768,1179
"4638",1970-01-01 17:00:00,"88a8a0756dfffff",1094,2022,3116
"4639",1970-01-01 17:00:00,"88a8a07633fffff",937,2014,2951
"4640",1970-01-01 17:00:00,"88a8a07637fffff",829,1840,2669
"4641",1970-01-01 17:00:00,"88a8a076c7fffff",577,1169,1746
"4642",1970-01-01 17:00:00,"88a8a076d1fffff",446,896,1342
"4643",1970-01-01 17:00:00,"88a8a076d3fffff",772,1701,2473
"4644",1970-01-01 17:00:00,"88a8a076d5fffff",259,633,892
"4645",1970-01-01 17:00:00,"88a8a076d7fffff",171,356,527
"4646",1970-01-01 17:00:00,"88a8a076e9fffff",790,1722,2512
"4647",1970-01-01 17:00:00,"88a8a076ebfffff",522,1021,1543
"4648",1970-01-01 17:00:00,"88a8a076edfffff",889,1943,2832
"4649",1970-01-01 17:30:00,"88a8a02801fffff",248,537,785
"4650",1970-01-01 17:30:00,"88a8a02809fffff",53,149,202
"4651",1970-01-01 17:30:00,"88a8a0280bfffff",299,687,986
"4652",1970-01-01 17:30:00,"88a8a02853fffff",236,605,841
"4653",1970-01-01 17:30:00,"88a8a02857fffff",284,676,960
"4654",1970-01-01 17:30:00,"88a8a02a01fffff",159,324,483
"4655",1970-01-01 17:30:00,"88a8a02a05fffff",330,680,1010
"4656",1970-01-01 17:30:00,"88a8a02a0bfffff",60,103,163
"4657",1970-01-01 17:30:00,"88a8a02a0dfffff",168,277,445
"4658",1970-01-01 17:30:00,"88a8a02a11fffff",102,300,402
"4659",1970-01-01 17:30:00,"88a8a02a13fffff",102,300,402
"4660",1970-01-01 17:30:00,"88a8a02a19fffff",51,150,201
"4661",1970-01-01 17:30:00,"88a8a02a57fffff",111,253,364
"4662",1970-01-01 17:30:00,"88a8a02a61fffff",111,253,364
"4663",1970-01-01 17:30:00,"88a8a02a63fffff",381,830,1211
"4664",1970-01-01 17:30:00,"88a8a02a69fffff",330,680,1010
"4665",1970-01-01 17:30:00,"88a8a02a6bfffff",111,253,364
"4666",1970-01-01 17:30:00,"88a8a02a6dfffff",48,71,119
"4667",1970-01-01 17:30:00,"88a8a02a89fffff",135,360,495
"4668",1970-01-01 17:30:00,"88a8a02a8bfffff",84,210,294
"4669",1970-01-01 17:30:00,"88a8a02a9dfffff",51,150,201
"4670",1970-01-01 17:30:00,"88a8a02aa9fffff",51,150,201
"4671",1970-01-01 17:30:00,"88a8a02aadfffff",284,676,960
"4672",1970-01-01 17:30:00,"88a8a02ac5fffff",102,300,402
"4673",1970-01-01 17:30:00,"88a8a02ac7fffff",237,660,897
"4674",1970-01-01 17:30:00,"88a8a02ae3fffff",236,605,841
"4675",1970-01-01 17:30:00,"88a8a02ae7fffff",185,455,640
"4676",1970-01-01 17:30:00,"88a8a02aebfffff",183,456,639
"4677",1970-01-01 17:30:00,"88a8a03987fffff",423,912,1335
"4678",1970-01-01 17:30:00,"88a8a03995fffff",486,1094,1580
"4679",1970-01-01 17:30:00,"88a8a03997fffff",441,933,1374
"4680",1970-01-01 17:30:00,"88a8a039a1fffff",954,1886,2840
"4681",1970-01-01 17:30:00,"88a8a039abfffff",1074,2092,3166
"4682",1970-01-01 17:30:00,"88a8a039adfffff",963,1839,2802
"4683",1970-01-01 17:30:00,"88a8a039b9fffff",912,1804,2716
"4684",1970-01-01 17:30:00,"88a8a039bbfffff",723,1427,2150
"4685",1970-01-01 17:30:00,"88a8a039bdfffff",393,747,1140
"4686",1970-01-01 17:30:00,"88a8a06085fffff",563,1313,1876
"4687",1970-01-01 17:30:00,"88a8a0608dfffff",566,1252,1818
"4688",1970-01-01 17:30:00,"88a8a060a3fffff",204,600,804
"4689",1970-01-01 17:30:00,"88a8a060a7fffff",102,300,402
"4690",1970-01-01 17:30:00,"88a8a060abfffff",252,684,936
"4691",1970-01-01 17:30:00,"88a8a060c1fffff",161,348,509
"4692",1970-01-01 17:30:00,"88a8a060c3fffff",475,1146,1621
"4693",1970-01-01 17:30:00,"88a8a060c7fffff",418,982,1400
"4694",1970-01-01 17:30:00,"88a8a060cbfffff",475,1146,1621
"4695",1970-01-01 17:30:00,"88a8a06193fffff",204,600,804
"4696",1970-01-01 17:30:00,"88a8a06197fffff",51,150,201
"4697",1970-01-01 17:30:00,"88a8a0619bfffff",51,150,201
"4698",1970-01-01 17:30:00,"88a8a061a1fffff",246,682,928
"4699",1970-01-01 17:30:00,"88a8a061a3fffff",246,682,928
"4700",1970-01-01 17:30:00,"88a8a061a5fffff",153,450,603
"4701",1970-01-01 17:30:00,"88a8a061b1fffff",144,382,526
"4702",1970-01-01 17:30:00,"88a8a061b3fffff",204,600,804
"4703",1970-01-01 17:30:00,"88a8a061b5fffff",246,682,928
"4704",1970-01-01 17:30:00,"88a8a061b7fffff",297,832,1129
"4705",1970-01-01 17:30:00,"88a8a06249fffff",651,1180,1831
"4706",1970-01-01 17:30:00,"88a8a0624bfffff",591,1077,1668
"4707",1970-01-01 17:30:00,"88a8a0624dfffff",771,1386,2157
"4708",1970-01-01 17:30:00,"88a8a06281fffff",335,758,1093
"4709",1970-01-01 17:30:00,"88a8a06283fffff",688,1584,2272
"4710",1970-01-01 17:30:00,"88a8a06287fffff",736,1795,2531
"4711",1970-01-01 17:30:00,"88a8a06289fffff",530,1290,1820
"4712",1970-01-01 17:30:00,"88a8a0628bfffff",303,731,1034
"4713",1970-01-01 17:30:00,"88a8a06293fffff",120,206,326
"4714",1970-01-01 17:30:00,"88a8a06299fffff",240,412,652
"4715",1970-01-01 17:30:00,"88a8a0629bfffff",240,412,652
"4716",1970-01-01 17:30:00,"88a8a062b5fffff",697,1652,2349
"4717",1970-01-01 17:30:00,"88a8a062bdfffff",730,1781,2511
"4718",1970-01-01 17:30:00,"88a8a062c1fffff",257,634,891
"4719",1970-01-01 17:30:00,"88a8a062c3fffff",375,841,1216
"4720",1970-01-01 17:30:00,"88a8a062cbfffff",488,1093,1581
"4721",1970-01-01 17:30:00,"88a8a062d1fffff",180,309,489
"4722",1970-01-01 17:30:00,"88a8a062d3fffff",240,412,652
"4723",1970-01-01 17:30:00,"88a8a062d9fffff",360,618,978
"4724",1970-01-01 17:30:00,"88a8a06541fffff",60,103,163
"4725",1970-01-01 17:30:00,"88a8a06549fffff",180,309,489
"4726",1970-01-01 17:30:00,"88a8a06705fffff",180,309,489
"4727",1970-01-01 17:30:00,"88a8a06707fffff",120,206,326
"4728",1970-01-01 17:30:00,"88a8a0670dfffff",120,206,326
"4729",1970-01-01 17:30:00,"88a8a0672bfffff",60,103,163
"4730",1970-01-01 17:30:00,"88a8a06731fffff",180,309,489
"4731",1970-01-01 17:30:00,"88a8a06735fffff",180,309,489
"4732",1970-01-01 17:30:00,"88a8a06739fffff",180,309,489
"4733",1970-01-01 17:30:00,"88a8a0673dfffff",0,0,0
"4734",1970-01-01 17:30:00,"88a8a0674dfffff",120,206,326
"4735",1970-01-01 17:30:00,"88a8a0676bfffff",120,206,326
"4736",1970-01-01 17:30:00,"88a8a06a91fffff",51,150,201
"4737",1970-01-01 17:30:00,"88a8a06a9bfffff",51,150,201
"4738",1970-01-01 17:30:00,"88a8a06e49fffff",204,600,804
"4739",1970-01-01 17:30:00,"88a8a06e4dfffff",204,600,804
"4740",1970-01-01 17:30:00,"88a8a06e6dfffff",204,600,804
"4741",1970-01-01 17:30:00,"88a8a070b3fffff",522,1021,1543
"4742",1970-01-01 17:30:00,"88a8a070b7fffff",591,1077,1668
"4743",1970-01-01 17:30:00,"88a8a0719bfffff",351,665,1016
"4744",1970-01-01 17:30:00,"88a8a07441fffff",724,1461,2185
"4745",1970-01-01 17:30:00,"88a8a07445fffff",505,1034,1539
"4746",1970-01-01 17:30:00,"88a8a07447fffff",334,678,1012
"4747",1970-01-01 17:30:00,"88a8a0744bfffff",616,1287,1903
"4748",1970-01-01 17:30:00,"88a8a07461fffff",1021,2066,3087
"4749",1970-01-01 17:30:00,"88a8a07465fffff",584,1123,1707
"4750",1970-01-01 17:30:00,"88a8a07467fffff",273,541,814
"4751",1970-01-01 17:30:00,"88a8a07469fffff",204,370,574
"4752",1970-01-01 17:30:00,"88a8a0746bfffff",838,1678,2516
"4753",1970-01-01 17:30:00,"88a8a07503fffff",60,103,163
"4754",1970-01-01 17:30:00,"88a8a07507fffff",734,1404,2138
"4755",1970-01-01 17:30:00,"88a8a07515fffff",582,1124,1706
"4756",1970-01-01 17:30:00,"88a8a0751dfffff",231,459,690
"4757",1970-01-01 17:30:00,"88a8a07521fffff",965,1863,2828
"4758",1970-01-01 17:30:00,"88a8a07525fffff",567,1063,1630
"4759",1970-01-01 17:30:00,"88a8a0752bfffff",1073,2062,3135
"4760",1970-01-01 17:30:00,"88a8a0752dfffff",1115,2259,3374
"4761",1970-01-01 17:30:00,"88a8a07531fffff",1061,2264,3325
"4762",1970-01-01 17:30:00,"88a8a07533fffff",240,412,652
"4763",1970-01-01 17:30:00,"88a8a07535fffff",539,1243,1782
"4764",1970-01-01 17:30:00,"88a8a07537fffff",240,412,652
"4765",1970-01-01 17:30:00,"88a8a07539fffff",1478,2931,4409
"4766",1970-01-01 17:30:00,"88a8a0753bfffff",60,103,163
"4767",1970-01-01 17:30:00,"88a8a0753dfffff",510,1014,1524
"4768",1970-01-01 17:30:00,"88a8a07543fffff",677,1355,2032
"4769",1970-01-01 17:30:00,"88a8a07545fffff",462,918,1380
"4770",1970-01-01 17:30:00,"88a8a07547fffff",635,1273,1908
"4771",1970-01-01 17:30:00,"88a8a07553fffff",180,309,489
"4772",1970-01-01 17:30:00,"88a8a07557fffff",231,459,690
"4773",1970-01-01 17:30:00,"88a8a07559fffff",644,1226,1870
"4774",1970-01-01 17:30:00,"88a8a0755bfffff",273,541,814
"4775",1970-01-01 17:30:00,"88a8a0755dfffff",684,1309,1993
"4776",1970-01-01 17:30:00,"88a8a07561fffff",960,1925,2885
"4777",1970-01-01 17:30:00,"88a8a07565fffff",342,597,939
"4778",1970-01-01 17:30:00,"88a8a07567fffff",1115,2259,3374
"4779",1970-01-01 17:30:00,"88a8a07569fffff",748,1525,2273
"4780",1970-01-01 17:30:00,"88a8a0756bfffff",568,1216,1784
"4781",1970-01-01 17:30:00,"88a8a0756dfffff",1016,2128,3144
"4782",1970-01-01 17:30:00,"88a8a07633fffff",607,1219,1826
"4783",1970-01-01 17:30:00,"88a8a07637fffff",623,1241,1864
"4784",1970-01-01 17:30:00,"88a8a076c7fffff",111,253,364
"4785",1970-01-01 17:30:00,"88a8a076d1fffff",351,665,1016
"4786",1970-01-01 17:30:00,"88a8a076d3fffff",783,1645,2428
"4787",1970-01-01 17:30:00,"88a8a076d5fffff",453,965,1418
"4788",1970-01-01 17:30:00,"88a8a076d7fffff",219,427,646
"4789",1970-01-01 17:30:00,"88a8a076e9fffff",431,785,1216
"4790",1970-01-01 17:30:00,"88a8a076ebfffff",233,458,691
"4791",1970-01-01 17:30:00,"88a8a076edfffff",494,967,1461
"4792",1970-01-01 18:00:00,"88a8a02801fffff",135,360,495
"4793",1970-01-01 18:00:00,"88a8a02805fffff",84,210,294
"4794",1970-01-01 18:00:00,"88a8a02809fffff",51,150,201
"4795",1970-01-01 18:00:00,"88a8a0280bfffff",183,431,614
"4796",1970-01-01 18:00:00,"88a8a02829fffff",33,60,93
"4797",1970-01-01 18:00:00,"88a8a0282dfffff",33,60,93
"4798",1970-01-01 18:00:00,"88a8a02853fffff",150,371,521
"4799",1970-01-01 18:00:00,"88a8a02857fffff",198,442,640
"4800",1970-01-01 18:00:00,"88a8a0291dfffff",33,60,93
"4801",1970-01-01 18:00:00,"88a8a02953fffff",33,60,93
"4802",1970-01-01 18:00:00,"88a8a02957fffff",33,60,93
"4803",1970-01-01 18:00:00,"88a8a02a01fffff",374,761,1135
"4804",1970-01-01 18:00:00,"88a8a02a05fffff",314,658,972
"4805",1970-01-01 18:00:00,"88a8a02a11fffff",48,71,119
"4806",1970-01-01 18:00:00,"88a8a02a19fffff",99,221,320
"4807",1970-01-01 18:00:00,"88a8a02a57fffff",51,150,201
"4808",1970-01-01 18:00:00,"88a8a02a61fffff",60,103,163
"4809",1970-01-01 18:00:00,"88a8a02a63fffff",263,508,771
"4810",1970-01-01 18:00:00,"88a8a02a69fffff",203,405,608
"4811",1970-01-01 18:00:00,"88a8a02a6bfffff",60,103,163
"4812",1970-01-01 18:00:00,"88a8a02a6dfffff",60,103,163
"4813",1970-01-01 18:00:00,"88a8a02a89fffff",255,516,771
"4814",1970-01-01 18:00:00,"88a8a02a8bfffff",306,666,972
"4815",1970-01-01 18:00:00,"88a8a02a9dfffff",207,420,627
"4816",1970-01-01 18:00:00,"88a8a02aadfffff",153,450,603
"4817",1970-01-01 18:00:00,"88a8a02ac5fffff",60,103,163
"4818",1970-01-01 18:00:00,"88a8a02ac7fffff",453,958,1411
"4819",1970-01-01 18:00:00,"88a8a02ae3fffff",150,371,521
"4820",1970-01-01 18:00:00,"88a8a02ae7fffff",201,521,722
"4821",1970-01-01 18:00:00,"88a8a02aebfffff",150,371,521
"4822",1970-01-01 18:00:00,"88a8a03987fffff",219,427,646
"4823",1970-01-01 18:00:00,"88a8a03995fffff",293,561,854
"4824",1970-01-01 18:00:00,"88a8a03997fffff",263,508,771
"4825",1970-01-01 18:00:00,"88a8a039a1fffff",385,828,1213
"4826",1970-01-01 18:00:00,"88a8a039abfffff",556,1184,1740
"4827",1970-01-01 18:00:00,"88a8a039adfffff",556,1184,1740
"4828",1970-01-01 18:00:00,"88a8a039b9fffff",399,736,1135
"4829",1970-01-01 18:00:00,"88a8a039bbfffff",560,1059,1619
"4830",1970-01-01 18:00:00,"88a8a039bdfffff",221,426,647
"4831",1970-01-01 18:00:00,"88a8a06081fffff",159,349,508
"4832",1970-01-01 18:00:00,"88a8a06085fffff",667,1718,2385
"4833",1970-01-01 18:00:00,"88a8a0608dfffff",916,2245,3161
"4834",1970-01-01 18:00:00,"88a8a060a3fffff",445,1212,1657
"4835",1970-01-01 18:00:00,"88a8a060a7fffff",95,231,326
"4836",1970-01-01 18:00:00,"88a8a060abfffff",350,866,1216
"4837",1970-01-01 18:00:00,"88a8a060c1fffff",231,459,690
"4838",1970-01-01 18:00:00,"88a8a060c3fffff",518,1168,1686
"4839",1970-01-01 18:00:00,"88a8a060c7fffff",465,1019,1484
"4840",1970-01-01 18:00:00,"88a8a060cbfffff",680,1571,2251
"4841",1970-01-01 18:00:00,"88a8a06193fffff",407,1018,1425
"4842",1970-01-01 18:00:00,"88a8a06197fffff",210,487,697
"4843",1970-01-01 18:00:00,"88a8a0619bfffff",164,402,566
"4844",1970-01-01 18:00:00,"88a8a061a1fffff",141,316,457
"4845",1970-01-01 18:00:00,"88a8a061a3fffff",141,316,457
"4846",1970-01-01 18:00:00,"88a8a061a5fffff",48,84,132
"4847",1970-01-01 18:00:00,"88a8a061b1fffff",99,234,333
"4848",1970-01-01 18:00:00,"88a8a061b3fffff",354,869,1223
"4849",1970-01-01 18:00:00,"88a8a061b5fffff",90,166,256
"4850",1970-01-01 18:00:00,"88a8a061b7fffff",294,766,1060
"4851",1970-01-01 18:00:00,"88a8a06249fffff",471,871,1342
"4852",1970-01-01 18:00:00,"88a8a0624bfffff",531,974,1505
"4853",1970-01-01 18:00:00,"88a8a0624dfffff",411,768,1179
"4854",1970-01-01 18:00:00,"88a8a06281fffff",422,997,1419
"4855",1970-01-01 18:00:00,"88a8a06283fffff",608,1346,1954
"4856",1970-01-01 18:00:00,"88a8a06287fffff",617,1414,2031
"4857",1970-01-01 18:00:00,"88a8a06289fffff",557,1196,1753
"4858",1970-01-01 18:00:00,"88a8a0628bfffff",245,512,757
"4859",1970-01-01 18:00:00,"88a8a06293fffff",300,515,815
"4860",1970-01-01 18:00:00,"88a8a06299fffff",180,309,489
"4861",1970-01-01 18:00:00,"88a8a0629bfffff",300,515,815
"4862",1970-01-01 18:00:00,"88a8a062b5fffff",599,1508,2107
"4863",1970-01-01 18:00:00,"88a8a062bdfffff",659,1611,2270
"4864",1970-01-01 18:00:00,"88a8a062c1fffff",287,709,996
"4865",1970-01-01 18:00:00,"88a8a062c3fffff",438,904,1342
"4866",1970-01-01 18:00:00,"88a8a062cbfffff",437,943,1380
"4867",1970-01-01 18:00:00,"88a8a062d1fffff",300,515,815
"4868",1970-01-01 18:00:00,"88a8a062d3fffff",360,618,978
"4869",1970-01-01 18:00:00,"88a8a062d9fffff",300,515,815
"4870",1970-01-01 18:00:00,"88a8a06541fffff",180,309,489
"4871",1970-01-01 18:00:00,"88a8a06549fffff",300,515,815
"4872",1970-01-01 18:00:00,"88a8a06705fffff",480,824,1304
"4873",1970-01-01 18:00:00,"88a8a06707fffff",360,618,978
"4874",1970-01-01 18:00:00,"88a8a0670dfffff",60,103,163
"4875",1970-01-01 18:00:00,"88a8a0672bfffff",180,309,489
"4876",1970-01-01 18:00:00,"88a8a06731fffff",300,515,815
"4877",1970-01-01 18:00:00,"88a8a06735fffff",360,618,978
"4878",1970-01-01 18:00:00,"88a8a06739fffff",360,618,978
"4879",1970-01-01 18:00:00,"88a8a0673dfffff",120,206,326
"4880",1970-01-01 18:00:00,"88a8a0674dfffff",420,721,1141
"4881",1970-01-01 18:00:00,"88a8a0676bfffff",240,412,652
"4882",1970-01-01 18:00:00,"88a8a06a9bfffff",51,150,201
"4883",1970-01-01 18:00:00,"88a8a06e49fffff",445,1212,1657
"4884",1970-01-01 18:00:00,"88a8a06e4dfffff",505,1315,1820
"4885",1970-01-01 18:00:00,"88a8a06e69fffff",144,382,526
"4886",1970-01-01 18:00:00,"88a8a06e6dfffff",354,869,1223
"4887",1970-01-01 18:00:00,"88a8a06f05fffff",51,150,201
"4888",1970-01-01 18:00:00,"88a8a06f63fffff",51,150,201
"4889",1970-01-01 18:00:00,"88a8a06f67fffff",102,300,402
"4890",1970-01-01 18:00:00,"88a8a06f69fffff",102,300,402
"4891",1970-01-01 18:00:00,"88a8a070b3fffff",591,1077,1668
"4892",1970-01-01 18:00:00,"88a8a070b7fffff",531,974,1505
"4893",1970-01-01 18:00:00,"88a8a0719bfffff",240,412,652
"4894",1970-01-01 18:00:00,"88a8a07441fffff",633,1159,1792
"4895",1970-01-01 18:00:00,"88a8a07445fffff",453,850,1303
"4896",1970-01-01 18:00:00,"88a8a07447fffff",411,768,1179
"4897",1970-01-01 18:00:00,"88a8a0744bfffff",633,1159,1792
"4898",1970-01-01 18:00:00,"88a8a07461fffff",1097,2076,3173
"4899",1970-01-01 18:00:00,"88a8a07465fffff",968,1917,2885
"4900",1970-01-01 18:00:00,"88a8a07467fffff",60,103,163
"4901",1970-01-01 18:00:00,"88a8a07469fffff",51,150,201
"4902",1970-01-01 18:00:00,"88a8a0746bfffff",1037,1973,3010
"4903",1970-01-01 18:00:00,"88a8a07503fffff",60,103,163
"4904",1970-01-01 18:00:00,"88a8a07507fffff",702,1377,2079
"4905",1970-01-01 18:00:00,"88a8a07509fffff",0,0,0
"4906",1970-01-01 18:00:00,"88a8a07515fffff",411,768,1179
"4907",1970-01-01 18:00:00,"88a8a0751dfffff",60,103,163
"4908",1970-01-01 18:00:00,"88a8a07521fffff",1038,2190,3228
"4909",1970-01-01 18:00:00,"88a8a07525fffff",723,1452,2175
"4910",1970-01-01 18:00:00,"88a8a0752bfffff",987,2040,3027
"4911",1970-01-01 18:00:00,"88a8a0752dfffff",816,1684,2500
"4912",1970-01-01 18:00:00,"88a8a07531fffff",974,1816,2790
"4913",1970-01-01 18:00:00,"88a8a07533fffff",240,412,652
"4914",1970-01-01 18:00:00,"88a8a07535fffff",527,1121,1648
"4915",1970-01-01 18:00:00,"88a8a07537fffff",180,309,489
"4916",1970-01-01 18:00:00,"88a8a07539fffff",954,1796,2750
"4917",1970-01-01 18:00:00,"88a8a0753bfffff",60,103,163
"4918",1970-01-01 18:00:00,"88a8a0753dfffff",210,499,709
"4919",1970-01-01 18:00:00,"88a8a07543fffff",584,1123,1707
"4920",1970-01-01 18:00:00,"88a8a07545fffff",360,618,978
"4921",1970-01-01 18:00:00,"88a8a07547fffff",575,1170,1745
"4922",1970-01-01 18:00:00,"88a8a07553fffff",60,103,163
"4923",1970-01-01 18:00:00,"88a8a07555fffff",0,0,0
"4924",1970-01-01 18:00:00,"88a8a07557fffff",60,103,163
"4925",1970-01-01 18:00:00,"88a8a07559fffff",737,1458,2195
"4926",1970-01-01 18:00:00,"88a8a0755bfffff",120,206,326
"4927",1970-01-01 18:00:00,"88a8a0755dfffff",524,1020,1544
"4928",1970-01-01 18:00:00,"88a8a07561fffff",828,1806,2634
"4929",1970-01-01 18:00:00,"88a8a07565fffff",162,403,565
"4930",1970-01-01 18:00:00,"88a8a07567fffff",867,1834,2701
"4931",1970-01-01 18:00:00,"88a8a07569fffff",522,1021,1543
"4932",1970-01-01 18:00:00,"88a8a0756bfffff",515,1067,1582
"4933",1970-01-01 18:00:00,"88a8a0756dfffff",1272,2447,3719
"4934",1970-01-01 18:00:00,"88a8a07633fffff",360,618,978
"4935",1970-01-01 18:00:00,"88a8a07637fffff",342,597,939
"4936",1970-01-01 18:00:00,"88a8a076c7fffff",212,473,685
"4937",1970-01-01 18:00:00,"88a8a076d1fffff",351,665,1016
"4938",1970-01-01 18:00:00,"88a8a076d3fffff",676,1390,2066
"4939",1970-01-01 18:00:00,"88a8a076d5fffff",453,965,1418
"4940",1970-01-01 18:00:00,"88a8a076d7fffff",212,473,685
"4941",1970-01-01 18:00:00,"88a8a076e9fffff",344,711,1055
"4942",1970-01-01 18:00:00,"88a8a076ebfffff",99,221,320
"4943",1970-01-01 18:00:00,"88a8a076edfffff",293,561,854
"4944",1970-01-01 18:30:00,"88a8a02801fffff",200,466,666
"4945",1970-01-01 18:30:00,"88a8a02805fffff",129,227,356
"4946",1970-01-01 18:30:00,"88a8a02809fffff",48,71,119
"4947",1970-01-01 18:30:00,"88a8a0280bfffff",147,317,464
"4948",1970-01-01 18:30:00,"88a8a02825fffff",33,60,93
"4949",1970-01-01 18:30:00,"88a8a02829fffff",129,227,356
"4950",1970-01-01 18:30:00,"88a8a0282dfffff",129,227,356
"4951",1970-01-01 18:30:00,"88a8a02853fffff",180,377,557
"4952",1970-01-01 18:30:00,"88a8a02857fffff",180,377,557
"4953",1970-01-01 18:30:00,"88a8a02919fffff",33,60,93
"4954",1970-01-01 18:30:00,"88a8a0291dfffff",48,96,144
"4955",1970-01-01 18:30:00,"88a8a02953fffff",129,227,356
"4956",1970-01-01 18:30:00,"88a8a02957fffff",96,167,263
"4957",1970-01-01 18:30:00,"88a8a02a01fffff",231,459,690
"4958",1970-01-01 18:30:00,"88a8a02a05fffff",279,530,809
"4959",1970-01-01 18:30:00,"88a8a02a09fffff",48,71,119
"4960",1970-01-01 18:30:00,"88a8a02a0bfffff",108,174,282
"4961",1970-01-01 18:30:00,"88a8a02a11fffff",102,300,402
"4962",1970-01-01 18:30:00,"88a8a02a13fffff",102,300,402
"4963",1970-01-01 18:30:00,"88a8a02a19fffff",261,624,885
"4964",1970-01-01 18:30:00,"88a8a02a1dfffff",0,0,0
"4965",1970-01-01 18:30:00,"88a8a02a57fffff",210,474,684
"4966",1970-01-01 18:30:00,"88a8a02a61fffff",162,403,565
"4967",1970-01-01 18:30:00,"88a8a02a63fffff",279,530,809
"4968",1970-01-01 18:30:00,"88a8a02a69fffff",219,427,646
"4969",1970-01-01 18:30:00,"88a8a02a6bfffff",48,71,119
"4970",1970-01-01 18:30:00,"88a8a02a89fffff",162,403,565
"4971",1970-01-01 18:30:00,"88a8a02a8bfffff",162,403,565
"4972",1970-01-01 18:30:00,"88a8a02a9dfffff",111,253,364
"4973",1970-01-01 18:30:00,"88a8a02aadfffff",180,377,557
"4974",1970-01-01 18:30:00,"88a8a02ac5fffff",261,624,885
"4975",1970-01-01 18:30:00,"88a8a02ac7fffff",213,553,766
"4976",1970-01-01 18:30:00,"88a8a02ae3fffff",231,527,758
"4977",1970-01-01 18:30:00,"88a8a02ae7fffff",180,377,557
"4978",1970-01-01 18:30:00,"88a8a02aebfffff",180,377,557
"4979",1970-01-01 18:30:00,"88a8a03987fffff",351,665,1016
"4980",1970-01-01 18:30:00,"88a8a03995fffff",348,586,934
"4981",1970-01-01 18:30:00,"88a8a03997fffff",279,530,809
"4982",1970-01-01 18:30:00,"88a8a039a1fffff",746,1526,2272
"4983",1970-01-01 18:30:00,"88a8a039abfffff",746,1526,2272
"4984",1970-01-01 18:30:00,"88a8a039adfffff",866,1732,2598
"4985",1970-01-01 18:30:00,"88a8a039b9fffff",914,1803,2717
"4986",1970-01-01 18:30:00,"88a8a039bbfffff",630,1195,1825
"4987",1970-01-01 18:30:00,"88a8a039bdfffff",284,608,892
"4988",1970-01-01 18:30:00,"88a8a06081fffff",51,150,201
"4989",1970-01-01 18:30:00,"88a8a06085fffff",495,1094,1589
"4990",1970-01-01 18:30:00,"88a8a0608dfffff",629,1536,2165
"4991",1970-01-01 18:30:00,"88a8a060a3fffff",381,881,1262
"4992",1970-01-01 18:30:00,"88a8a060a7fffff",84,164,248
"4993",1970-01-01 18:30:00,"88a8a060abfffff",330,731,1061
"4994",1970-01-01 18:30:00,"88a8a060c1fffff",201,431,632
"4995",1970-01-01 18:30:00,"88a8a060c3fffff",626,1482,2108
"4996",1970-01-01 18:30:00,"88a8a060c7fffff",779,1932,2711
"4997",1970-01-01 18:30:00,"88a8a060cbfffff",668,1564,2232
"4998",1970-01-01 18:30:00,"88a8a06193fffff",321,663,984
"4999",1970-01-01 18:30:00,"88a8a06197fffff",279,581,860
"5000",1970-01-01 18:30:00,"88a8a0619bfffff",135,314,449
"5001",1970-01-01 18:30:00,"88a8a061a1fffff",246,682,928
"5002",1970-01-01 18:30:00,"88a8a061a3fffff",288,764,1052
"5003",1970-01-01 18:30:00,"88a8a061a5fffff",195,532,727
"5004",1970-01-01 18:30:00,"88a8a061b1fffff",246,567,813
"5005",1970-01-01 18:30:00,"88a8a061b3fffff",474,1113,1587
"5006",1970-01-01 18:30:00,"88a8a061b5fffff",381,996,1377
"5007",1970-01-01 18:30:00,"88a8a061b7fffff",492,1134,1626
"5008",1970-01-01 18:30:00,"88a8a06249fffff",711,1283,1994
"5009",1970-01-01 18:30:00,"88a8a0624bfffff",651,1180,1831
"5010",1970-01-01 18:30:00,"88a8a0624dfffff",591,1077,1668
"5011",1970-01-01 18:30:00,"88a8a06281fffff",266,702,968
"5012",1970-01-01 18:30:00,"88a8a06283fffff",722,1883,2605
"5013",1970-01-01 18:30:00,"88a8a06287fffff",611,1515,2126
"5014",1970-01-01 18:30:00,"88a8a06289fffff",632,1590,2222
"5015",1970-01-01 18:30:00,"88a8a0628bfffff",111,253,364
"5016",1970-01-01 18:30:00,"88a8a06293fffff",180,309,489
"5017",1970-01-01 18:30:00,"88a8a06299fffff",120,206,326
"5018",1970-01-01 18:30:00,"88a8a0629bfffff",120,206,326
"5019",1970-01-01 18:30:00,"88a8a062b5fffff",629,1421,2050
"5020",1970-01-01 18:30:00,"88a8a062bdfffff",578,1386,1964
"5021",1970-01-01 18:30:00,"88a8a062c1fffff",93,232,325
"5022",1970-01-01 18:30:00,"88a8a062c3fffff",572,1487,2059
"5023",1970-01-01 18:30:00,"88a8a062cbfffff",512,1384,1896
"5024",1970-01-01 18:30:00,"88a8a062d1fffff",300,515,815
"5025",1970-01-01 18:30:00,"88a8a062d3fffff",360,618,978
"5026",1970-01-01 18:30:00,"88a8a062d9fffff",300,515,815
"5027",1970-01-01 18:30:00,"88a8a06541fffff",120,206,326
"5028",1970-01-01 18:30:00,"88a8a06549fffff",180,309,489
"5029",1970-01-01 18:30:00,"88a8a06705fffff",360,618,978
"5030",1970-01-01 18:30:00,"88a8a06707fffff",300,515,815
"5031",1970-01-01 18:30:00,"88a8a0670dfffff",240,412,652
"5032",1970-01-01 18:30:00,"88a8a0672bfffff",240,412,652
"5033",1970-01-01 18:30:00,"88a8a06731fffff",180,309,489
"5034",1970-01-01 18:30:00,"88a8a06735fffff",240,412,652
"5035",1970-01-01 18:30:00,"88a8a06739fffff",240,412,652
"5036",1970-01-01 18:30:00,"88a8a0674dfffff",180,309,489
"5037",1970-01-01 18:30:00,"88a8a0676bfffff",240,412,652
"5038",1970-01-01 18:30:00,"88a8a06a91fffff",48,84,132
"5039",1970-01-01 18:30:00,"88a8a06a9bfffff",48,84,132
"5040",1970-01-01 18:30:00,"88a8a06e49fffff",237,614,851
"5041",1970-01-01 18:30:00,"88a8a06e4dfffff",321,778,1099
"5042",1970-01-01 18:30:00,"88a8a06e69fffff",153,335,488
"5043",1970-01-01 18:30:00,"88a8a06e6dfffff",423,963,1386
"5044",1970-01-01 18:30:00,"88a8a06f05fffff",99,234,333
"5045",1970-01-01 18:30:00,"88a8a06f61fffff",51,150,201
"5046",1970-01-01 18:30:00,"88a8a06f63fffff",48,84,132
"5047",1970-01-01 18:30:00,"88a8a06f67fffff",198,468,666
"5048",1970-01-01 18:30:00,"88a8a06f69fffff",147,318,465
"5049",1970-01-01 18:30:00,"88a8a070b3fffff",531,974,1505
"5050",1970-01-01 18:30:00,"88a8a070b7fffff",651,1180,1831
"5051",1970-01-01 18:30:00,"88a8a0719bfffff",240,412,652
"5052",1970-01-01 18:30:00,"88a8a07441fffff",653,1406,2059
"5053",1970-01-01 18:30:00,"88a8a07443fffff",60,103,163
"5054",1970-01-01 18:30:00,"88a8a07445fffff",443,932,1375
"5055",1970-01-01 18:30:00,"88a8a07447fffff",263,623,886
"5056",1970-01-01 18:30:00,"88a8a0744bfffff",617,1367,1984
"5057",1970-01-01 18:30:00,"88a8a07461fffff",1219,2623,3842
"5058",1970-01-01 18:30:00,"88a8a07465fffff",612,1289,1901
"5059",1970-01-01 18:30:00,"88a8a07467fffff",335,758,1093
"5060",1970-01-01 18:30:00,"88a8a07469fffff",266,702,968
"5061",1970-01-01 18:30:00,"88a8a0746bfffff",866,1959,2825
"5062",1970-01-01 18:30:00,"88a8a07503fffff",60,103,163
"5063",1970-01-01 18:30:00,"88a8a07507fffff",848,1711,2559
"5064",1970-01-01 18:30:00,"88a8a07515fffff",746,1526,2272
"5065",1970-01-01 18:30:00,"88a8a0751dfffff",335,758,1093
"5066",1970-01-01 18:30:00,"88a8a07521fffff",795,1562,2357
"5067",1970-01-01 18:30:00,"88a8a07525fffff",420,721,1141
"5068",1970-01-01 18:30:00,"88a8a0752bfffff",959,1964,2923
"5069",1970-01-01 18:30:00,"88a8a0752dfffff",735,1459,2194
"5070",1970-01-01 18:30:00,"88a8a07531fffff",932,2105,3037
"5071",1970-01-01 18:30:00,"88a8a07533fffff",300,515,815
"5072",1970-01-01 18:30:00,"88a8a07535fffff",419,1152,1571
"5073",1970-01-01 18:30:00,"88a8a07537fffff",300,515,815
"5074",1970-01-01 18:30:00,"88a8a07539fffff",1259,2594,3853
"5075",1970-01-01 18:30:00,"88a8a0753bfffff",284,608,892
"5076",1970-01-01 18:30:00,"88a8a0753dfffff",495,1047,1542
"5077",1970-01-01 18:30:00,"88a8a07543fffff",795,1677,2472
"5078",1970-01-01 18:30:00,"88a8a07545fffff",453,965,1418
"5079",1970-01-01 18:30:00,"88a8a07547fffff",864,1733,2597
"5080",1970-01-01 18:30:00,"88a8a07553fffff",335,758,1093
"5081",1970-01-01 18:30:00,"88a8a07557fffff",224,505,729
"5082",1970-01-01 18:30:00,"88a8a07559fffff",633,1274,1907
"5083",1970-01-01 18:30:00,"88a8a0755bfffff",275,655,930
"5084",1970-01-01 18:30:00,"88a8a0755dfffff",675,1471,2146
"5085",1970-01-01 18:30:00,"88a8a07561fffff",504,1000,1504
"5086",1970-01-01 18:30:00,"88a8a07565fffff",291,562,853
"5087",1970-01-01 18:30:00,"88a8a07567fffff",786,1609,2395
"5088",1970-01-01 18:30:00,"88a8a07569fffff",624,1321,1945
"5089",1970-01-01 18:30:00,"88a8a0756bfffff",693,1377,2070
"5090",1970-01-01 18:30:00,"88a8a0756dfffff",1197,2377,3574
"5091",1970-01-01 18:30:00,"88a8a07633fffff",707,1405,2112
"5092",1970-01-01 18:30:00,"88a8a07637fffff",626,1320,1946
"5093",1970-01-01 18:30:00,"88a8a076c7fffff",233,458,691
"5094",1970-01-01 18:30:00,"88a8a076d1fffff",402,700,1102
"5095",1970-01-01 18:30:00,"88a8a076d3fffff",899,1861,2760
"5096",1970-01-01 18:30:00,"88a8a076d5fffff",605,1220,1825
"5097",1970-01-01 18:30:00,"88a8a076d7fffff",273,541,814
"5098",1970-01-01 18:30:00,"88a8a076e9fffff",587,1199,1786
"5099",1970-01-01 18:30:00,"88a8a076ebfffff",344,711,1055
"5100",1970-01-01 18:30:00,"88a8a076edfffff",539,1128,1667
"5101",1970-01-01 19:00:00,"88a8a02801fffff",147,317,464
"5102",1970-01-01 19:00:00,"88a8a02805fffff",96,167,263
"5103",1970-01-01 19:00:00,"88a8a02809fffff",104,299,403
"5104",1970-01-01 19:00:00,"88a8a0280bfffff",203,520,723
"5105",1970-01-01 19:00:00,"88a8a02825fffff",48,96,144
"5106",1970-01-01 19:00:00,"88a8a02829fffff",96,167,263
"5107",1970-01-01 19:00:00,"88a8a0282dfffff",96,167,263
"5108",1970-01-01 19:00:00,"88a8a02853fffff",152,370,522
"5109",1970-01-01 19:00:00,"88a8a02857fffff",251,616,867
"5110",1970-01-01 19:00:00,"88a8a02919fffff",96,167,263
"5111",1970-01-01 19:00:00,"88a8a0291dfffff",48,71,119
"5112",1970-01-01 19:00:00,"88a8a02953fffff",96,167,263
"5113",1970-01-01 19:00:00,"88a8a02957fffff",48,71,119
"5114",1970-01-01 19:00:00,"88a8a02a01fffff",377,840,1217
"5115",1970-01-01 19:00:00,"88a8a02a05fffff",476,1061,1537
"5116",1970-01-01 19:00:00,"88a8a02a0bfffff",111,253,364
"5117",1970-01-01 19:00:00,"88a8a02a0dfffff",0,0,0
"5118",1970-01-01 19:00:00,"88a8a02a11fffff",257,634,891
"5119",1970-01-01 19:00:00,"88a8a02a13fffff",257,634,891
"5120",1970-01-01 19:00:00,"88a8a02a19fffff",171,356,527
"5121",1970-01-01 19:00:00,"88a8a02a57fffff",219,427,646
"5122",1970-01-01 19:00:00,"88a8a02a61fffff",282,609,891
"5123",1970-01-01 19:00:00,"88a8a02a63fffff",377,840,1217
"5124",1970-01-01 19:00:00,"88a8a02a69fffff",527,1211,1738
"5125",1970-01-01 19:00:00,"88a8a02a6bfffff",93,232,325
"5126",1970-01-01 19:00:00,"88a8a02a89fffff",410,831,1241
"5127",1970-01-01 19:00:00,"88a8a02a8bfffff",501,949,1450
"5128",1970-01-01 19:00:00,"88a8a02a9dfffff",195,348,543
"5129",1970-01-01 19:00:00,"88a8a02aadfffff",251,616,867
"5130",1970-01-01 19:00:00,"88a8a02ac5fffff",388,907,1295
"5131",1970-01-01 19:00:00,"88a8a02ac7fffff",454,1027,1481
"5132",1970-01-01 19:00:00,"88a8a02ae3fffff",200,466,666
"5133",1970-01-01 19:00:00,"88a8a02ae7fffff",251,616,867
"5134",1970-01-01 19:00:00,"88a8a02aebfffff",188,509,697
"5135",1970-01-01 19:00:00,"88a8a03987fffff",479,1140,1619
"5136",1970-01-01 19:00:00,"88a8a03995fffff",462,918,1380
"5137",1970-01-01 19:00:00,"88a8a03997fffff",590,1393,1983
"5138",1970-01-01 19:00:00,"88a8a039a1fffff",710,1599,2309
"5139",1970-01-01 19:00:00,"88a8a039abfffff",770,1702,2472
"5140",1970-01-01 19:00:00,"88a8a039adfffff",809,1820,2629
"5141",1970-01-01 19:00:00,"88a8a039b9fffff",1010,2114,3124
"5142",1970-01-01 19:00:00,"88a8a039bbfffff",865,2048,2913
"5143",1970-01-01 19:00:00,"88a8a039bdfffff",291,562,853
"5144",1970-01-01 19:00:00,"88a8a06081fffff",219,452,671
"5145",1970-01-01 19:00:00,"88a8a06085fffff",525,1352,1877
"5146",1970-01-01 19:00:00,"88a8a0608dfffff",735,1736,2471
"5147",1970-01-01 19:00:00,"88a8a060a3fffff",312,799,1111
"5148",1970-01-01 19:00:00,"88a8a060abfffff",414,1099,1513
"5149",1970-01-01 19:00:00,"88a8a060c3fffff",474,1087,1561
"5150",1970-01-01 19:00:00,"88a8a060c7fffff",474,1087,1561
"5151",1970-01-01 19:00:00,"88a8a060cbfffff",474,1087,1561
"5152",1970-01-01 19:00:00,"88a8a06193fffff",150,396,546
"5153",1970-01-01 19:00:00,"88a8a06197fffff",198,480,678
"5154",1970-01-01 19:00:00,"88a8a0619bfffff",99,246,345
"5155",1970-01-01 19:00:00,"88a8a061a1fffff",243,616,859
"5156",1970-01-01 19:00:00,"88a8a061a3fffff",234,548,782
"5157",1970-01-01 19:00:00,"88a8a061a5fffff",243,616,859
"5158",1970-01-01 19:00:00,"88a8a061b1fffff",300,665,965
"5159",1970-01-01 19:00:00,"88a8a061b3fffff",258,583,841
"5160",1970-01-01 19:00:00,"88a8a061b5fffff",240,562,802
"5161",1970-01-01 19:00:00,"88a8a061b7fffff",291,597,888
"5162",1970-01-01 19:00:00,"88a8a06249fffff",360,618,978
"5163",1970-01-01 19:00:00,"88a8a0624bfffff",300,515,815
"5164",1970-01-01 19:00:00,"88a8a0624dfffff",540,927,1467
"5165",1970-01-01 19:00:00,"88a8a06281fffff",248,681,929
"5166",1970-01-01 19:00:00,"88a8a06283fffff",575,1332,1907
"5167",1970-01-01 19:00:00,"88a8a06287fffff",575,1332,1907
"5168",1970-01-01 19:00:00,"88a8a06289fffff",245,627,872
"5169",1970-01-01 19:00:00,"88a8a0628bfffff",159,349,508
"5170",1970-01-01 19:00:00,"88a8a06293fffff",300,515,815
"5171",1970-01-01 19:00:00,"88a8a06299fffff",180,309,489
"5172",1970-01-01 19:00:00,"88a8a0629bfffff",300,515,815
"5173",1970-01-01 19:00:00,"88a8a062b5fffff",534,1305,1839
"5174",1970-01-01 19:00:00,"88a8a062bdfffff",522,1183,1705
"5175",1970-01-01 19:00:00,"88a8a062c1fffff",141,328,469
"5176",1970-01-01 19:00:00,"88a8a062c3fffff",194,477,671
"5177",1970-01-01 19:00:00,"88a8a062cbfffff",287,709,996
"5178",1970-01-01 19:00:00,"88a8a062d1fffff",240,412,652
"5179",1970-01-01 19:00:00,"88a8a062d3fffff",360,618,978
"5180",1970-01-01 19:00:00,"88a8a062d9fffff",360,618,978
"5181",1970-01-01 19:00:00,"88a8a06541fffff",120,206,326
"5182",1970-01-01 19:00:00,"88a8a06549fffff",240,412,652
"5183",1970-01-01 19:00:00,"88a8a06705fffff",420,721,1141
"5184",1970-01-01 19:00:00,"88a8a06707fffff",360,618,978
"5185",1970-01-01 19:00:00,"88a8a0670dfffff",240,412,652
"5186",1970-01-01 19:00:00,"88a8a0672bfffff",120,206,326
"5187",1970-01-01 19:00:00,"88a8a06731fffff",300,515,815
"5188",1970-01-01 19:00:00,"88a8a06735fffff",300,515,815
"5189",1970-01-01 19:00:00,"88a8a06739fffff",360,618,978
"5190",1970-01-01 19:00:00,"88a8a0673dfffff",60,103,163
"5191",1970-01-01 19:00:00,"88a8a0674dfffff",180,309,489
"5192",1970-01-01 19:00:00,"88a8a0676bfffff",180,309,489
"5193",1970-01-01 19:00:00,"88a8a06a91fffff",51,150,201
"5194",1970-01-01 19:00:00,"88a8a06e49fffff",201,534,735
"5195",1970-01-01 19:00:00,"88a8a06e4dfffff",258,583,841
"5196",1970-01-01 19:00:00,"88a8a06e69fffff",48,84,132
"5197",1970-01-01 19:00:00,"88a8a06e6dfffff",198,480,678
"5198",1970-01-01 19:00:00,"88a8a06f05fffff",51,150,201
"5199",1970-01-01 19:00:00,"88a8a06f61fffff",51,150,201
"5200",1970-01-01 19:00:00,"88a8a06f63fffff",51,150,201
"5201",1970-01-01 19:00:00,"88a8a070b3fffff",660,1133,1793
"5202",1970-01-01 19:00:00,"88a8a070b7fffff",360,618,978
"5203",1970-01-01 19:00:00,"88a8a0719bfffff",300,515,815
"5204",1970-01-01 19:00:00,"88a8a07441fffff",732,1495,2227
"5205",1970-01-01 19:00:00,"88a8a07445fffff",402,815,1217
"5206",1970-01-01 19:00:00,"88a8a07447fffff",783,1645,2428
"5207",1970-01-01 19:00:00,"88a8a0744bfffff",681,1345,2026
"5208",1970-01-01 19:00:00,"88a8a07461fffff",1017,2183,3200
"5209",1970-01-01 19:00:00,"88a8a07465fffff",804,1630,2434
"5210",1970-01-01 19:00:00,"88a8a07467fffff",113,252,365
"5211",1970-01-01 19:00:00,"88a8a07469fffff",120,206,326
"5212",1970-01-01 19:00:00,"88a8a0746bfffff",975,1986,2961
"5213",1970-01-01 19:00:00,"88a8a07503fffff",60,103,163
"5214",1970-01-01 19:00:00,"88a8a07507fffff",776,1601,2377
"5215",1970-01-01 19:00:00,"88a8a07515fffff",531,974,1505
"5216",1970-01-01 19:00:00,"88a8a0751dfffff",111,253,364
"5217",1970-01-01 19:00:00,"88a8a07521fffff",769,1647,2416
"5218",1970-01-01 19:00:00,"88a8a07525fffff",268,586,854
"5219",1970-01-01 19:00:00,"88a8a0752bfffff",716,1498,2214
"5220",1970-01-01 19:00:00,"88a8a0752dfffff",781,1654,2435
"5221",1970-01-01 19:00:00,"88a8a07531fffff",949,1841,2790
"5222",1970-01-01 19:00:00,"88a8a07533fffff",180,309,489
"5223",1970-01-01 19:00:00,"88a8a07535fffff",358,879,1237
"5224",1970-01-01 19:00:00,"88a8a07537fffff",360,618,978
"5225",1970-01-01 19:00:00,"88a8a07539fffff",961,1848,2809
"5226",1970-01-01 19:00:00,"88a8a0753bfffff",51,150,201
"5227",1970-01-01 19:00:00,"88a8a0753dfffff",272,601,873
"5228",1970-01-01 19:00:00,"88a8a07543fffff",702,1330,2032
"5229",1970-01-01 19:00:00,"88a8a07545fffff",291,562,853
"5230",1970-01-01 19:00:00,"88a8a07547fffff",531,974,1505
"5231",1970-01-01 19:00:00,"88a8a07553fffff",51,150,201
"5232",1970-01-01 19:00:00,"88a8a07557fffff",113,252,365
"5233",1970-01-01 19:00:00,"88a8a07559fffff",693,1377,2070
"5234",1970-01-01 19:00:00,"88a8a0755bfffff",164,402,566
"5235",1970-01-01 19:00:00,"88a8a0755dfffff",651,1180,1831
"5236",1970-01-01 19:00:00,"88a8a07561fffff",910,1813,2723
"5237",1970-01-01 19:00:00,"88a8a07565fffff",60,103,163
"5238",1970-01-01 19:00:00,"88a8a07567fffff",850,1710,2560
"5239",1970-01-01 19:00:00,"88a8a07569fffff",591,1077,1668
"5240",1970-01-01 19:00:00,"88a8a0756bfffff",291,562,853
"5241",1970-01-01 19:00:00,"88a8a0756dfffff",1115,2097,3212
"5242",1970-01-01 19:00:00,"88a8a07633fffff",827,1841,2668
"5243",1970-01-01 19:00:00,"88a8a07637fffff",612,1289,1901
"5244",1970-01-01 19:00:00,"88a8a076c7fffff",330,680,1010
"5245",1970-01-01 19:00:00,"88a8a076d1fffff",353,664,1017
"5246",1970-01-01 19:00:00,"88a8a076d3fffff",767,1623,2390
"5247",1970-01-01 19:00:00,"88a8a076d5fffff",515,1067,1582
"5248",1970-01-01 19:00:00,"88a8a076d7fffff",317,737,1054
"5249",1970-01-01 19:00:00,"88a8a076e9fffff",501,1036,1537
"5250",1970-01-01 19:00:00,"88a8a076ebfffff",324,806,1130
"5251",1970-01-01 19:00:00,"88a8a076edfffff",612,1289,1901
"5252",1970-01-01 19:30:00,"88a8a02801fffff",84,210,294
"5253",1970-01-01 19:30:00,"88a8a02805fffff",84,210,294
"5254",1970-01-01 19:30:00,"88a8a02809fffff",51,150,201
"5255",1970-01-01 19:30:00,"88a8a0280bfffff",33,60,93
"5256",1970-01-01 19:30:00,"88a8a02829fffff",84,210,294
"5257",1970-01-01 19:30:00,"88a8a0282dfffff",84,210,294
"5258",1970-01-01 19:30:00,"88a8a02853fffff",33,60,93
"5259",1970-01-01 19:30:00,"88a8a02857fffff",33,60,93
"5260",1970-01-01 19:30:00,"88a8a0291dfffff",51,150,201
"5261",1970-01-01 19:30:00,"88a8a02953fffff",84,210,294
"5262",1970-01-01 19:30:00,"88a8a02957fffff",51,150,201
"5263",1970-01-01 19:30:00,"88a8a02a01fffff",312,774,1086
"5264",1970-01-01 19:30:00,"88a8a02a05fffff",321,727,1048
"5265",1970-01-01 19:30:00,"88a8a02a0bfffff",60,103,163
"5266",1970-01-01 19:30:00,"88a8a02a11fffff",219,427,646
"5267",1970-01-01 19:30:00,"88a8a02a13fffff",168,277,445
"5268",1970-01-01 19:30:00,"88a8a02a19fffff",272,576,848
"5269",1970-01-01 19:30:00,"88a8a02a1dfffff",51,150,201
"5270",1970-01-01 19:30:00,"88a8a02a57fffff",101,220,321
"5271",1970-01-01 19:30:00,"88a8a02a61fffff",51,150,201
"5272",1970-01-01 19:30:00,"88a8a02a63fffff",273,656,929
"5273",1970-01-01 19:30:00,"88a8a02a69fffff",375,841,1216
"5274",1970-01-01 19:30:00,"88a8a02a6bfffff",111,253,364
"5275",1970-01-01 19:30:00,"88a8a02a6dfffff",60,103,163
"5276",1970-01-01 19:30:00,"88a8a02a89fffff",207,445,652
"5277",1970-01-01 19:30:00,"88a8a02a8bfffff",152,395,547
"5278",1970-01-01 19:30:00,"88a8a02a9dfffff",152,395,547
"5279",1970-01-01 19:30:00,"88a8a02aadfffff",33,60,93
"5280",1970-01-01 19:30:00,"88a8a02ac5fffff",159,324,483
"5281",1970-01-01 19:30:00,"88a8a02ac7fffff",315,619,934
"5282",1970-01-01 19:30:00,"88a8a02ae3fffff",33,60,93
"5283",1970-01-01 19:30:00,"88a8a02ae7fffff",33,60,93
"5284",1970-01-01 19:30:00,"88a8a02aebfffff",144,263,407
"5285",1970-01-01 19:30:00,"88a8a03987fffff",263,623,886
"5286",1970-01-01 19:30:00,"88a8a03995fffff",351,665,1016
"5287",1970-01-01 19:30:00,"88a8a03997fffff",546,1197,1743
"5288",1970-01-01 19:30:00,"88a8a039a1fffff",590,1393,1983
"5289",1970-01-01 19:30:00,"88a8a039abfffff",770,1702,2472
"5290",1970-01-01 19:30:00,"88a8a039adfffff",661,1448,2109
"5291",1970-01-01 19:30:00,"88a8a039b9fffff",578,1361,1939
"5292",1970-01-01 19:30:00,"88a8a039bbfffff",641,1428,2069
"5293",1970-01-01 19:30:00,"88a8a039bdfffff",342,712,1054
"5294",1970-01-01 19:30:00,"88a8a06085fffff",350,748,1098
"5295",1970-01-01 19:30:00,"88a8a0608dfffff",563,1313,1876
"5296",1970-01-01 19:30:00,"88a8a060a3fffff",312,787,1099
"5297",1970-01-01 19:30:00,"88a8a060abfffff",263,636,899
"5298",1970-01-01 19:30:00,"88a8a060c1fffff",120,206,326
"5299",1970-01-01 19:30:00,"88a8a060c3fffff",517,1228,1745
"5300",1970-01-01 19:30:00,"88a8a060c7fffff",566,1379,1945
"5301",1970-01-01 19:30:00,"88a8a060cbfffff",520,1282,1802
"5302",1970-01-01 19:30:00,"88a8a06193fffff",264,703,967
"5303",1970-01-01 19:30:00,"88a8a06197fffff",264,703,967
"5304",1970-01-01 19:30:00,"88a8a0619bfffff",102,300,402
"5305",1970-01-01 19:30:00,"88a8a061a1fffff",201,546,747
"5306",1970-01-01 19:30:00,"88a8a061a3fffff",201,546,747
"5307",1970-01-01 19:30:00,"88a8a061a5fffff",201,546,747
"5308",1970-01-01 19:30:00,"88a8a061b1fffff",153,450,603
"5309",1970-01-01 19:30:00,"88a8a061b3fffff",204,600,804
"5310",1970-01-01 19:30:00,"88a8a061b5fffff",195,532,727
"5311",1970-01-01 19:30:00,"88a8a061b7fffff",255,750,1005
"5312",1970-01-01 19:30:00,"88a8a06249fffff",300,515,815
"5313",1970-01-01 19:30:00,"88a8a0624bfffff",360,618,978
"5314",1970-01-01 19:30:00,"88a8a0624dfffff",180,309,489
"5315",1970-01-01 19:30:00,"88a8a06281fffff",257,634,891
"5316",1970-01-01 19:30:00,"88a8a06283fffff",470,1187,1657
"5317",1970-01-01 19:30:00,"88a8a06287fffff",368,887,1255
"5318",1970-01-01 19:30:00,"88a8a06289fffff",578,1386,1964
"5319",1970-01-01 19:30:00,"88a8a0628bfffff",120,206,326
"5320",1970-01-01 19:30:00,"88a8a06293fffff",60,103,163
"5321",1970-01-01 19:30:00,"88a8a06299fffff",240,412,652
"5322",1970-01-01 19:30:00,"88a8a0629bfffff",180,309,489
"5323",1970-01-01 19:30:00,"88a8a062b5fffff",520,1282,1802
"5324",1970-01-01 19:30:00,"88a8a062bdfffff",514,1383,1897
"5325",1970-01-01 19:30:00,"88a8a062c1fffff",416,983,1399
"5326",1970-01-01 19:30:00,"88a8a062c3fffff",425,1051,1476
"5327",1970-01-01 19:30:00,"88a8a062cbfffff",425,1051,1476
"5328",1970-01-01 19:30:00,"88a8a062d1fffff",300,515,815
"5329",1970-01-01 19:30:00,"88a8a062d3fffff",180,309,489
"5330",1970-01-01 19:30:00,"88a8a062d9fffff",360,618,978
"5331",1970-01-01 19:30:00,"88a8a06541fffff",180,309,489
"5332",1970-01-01 19:30:00,"88a8a06549fffff",300,515,815
"5333",1970-01-01 19:30:00,"88a8a06705fffff",300,515,815
"5334",1970-01-01 19:30:00,"88a8a06707fffff",180,309,489
"5335",1970-01-01 19:30:00,"88a8a0670dfffff",60,103,163
"5336",1970-01-01 19:30:00,"88a8a0672bfffff",120,206,326
"5337",1970-01-01 19:30:00,"88a8a06731fffff",300,515,815
"5338",1970-01-01 19:30:00,"88a8a06735fffff",300,515,815
"5339",1970-01-01 19:30:00,"88a8a06739fffff",300,515,815
"5340",1970-01-01 19:30:00,"88a8a0673dfffff",120,206,326
"5341",1970-01-01 19:30:00,"88a8a0674dfffff",120,206,326
"5342",1970-01-01 19:30:00,"88a8a0676bfffff",180,309,489
"5343",1970-01-01 19:30:00,"88a8a06a9bfffff",0,0,0
"5344",1970-01-01 19:30:00,"88a8a06e49fffff",162,403,565
"5345",1970-01-01 19:30:00,"88a8a06e4dfffff",264,703,967
"5346",1970-01-01 19:30:00,"88a8a06e69fffff",51,150,201
"5347",1970-01-01 19:30:00,"88a8a06e6dfffff",264,703,967
"5348",1970-01-01 19:30:00,"88a8a06f61fffff",51,150,201
"5349",1970-01-01 19:30:00,"88a8a06f63fffff",51,150,201
"5350",1970-01-01 19:30:00,"88a8a06f67fffff",51,150,201
"5351",1970-01-01 19:30:00,"88a8a070b3fffff",240,412,652
"5352",1970-01-01 19:30:00,"88a8a070b7fffff",360,618,978
"5353",1970-01-01 19:30:00,"88a8a0719bfffff",120,206,326
"5354",1970-01-01 19:30:00,"88a8a07441fffff",693,1377,2070
"5355",1970-01-01 19:30:00,"88a8a07445fffff",291,562,853
"5356",1970-01-01 19:30:00,"88a8a07447fffff",462,918,1380
"5357",1970-01-01 19:30:00,"88a8a0744bfffff",693,1377,2070
"5358",1970-01-01 19:30:00,"88a8a07461fffff",1041,1988,3029
"5359",1970-01-01 19:30:00,"88a8a07465fffff",813,1583,2396
"5360",1970-01-01 19:30:00,"88a8a07467fffff",111,253,364
"5361",1970-01-01 19:30:00,"88a8a07469fffff",111,253,364
"5362",1970-01-01 19:30:00,"88a8a0746bfffff",771,1386,2157
"5363",1970-01-01 19:30:00,"88a8a07503fffff",60,103,163
"5364",1970-01-01 19:30:00,"88a8a07507fffff",675,1356,2031
"5365",1970-01-01 19:30:00,"88a8a07509fffff",0,0,0
"5366",1970-01-01 19:30:00,"88a8a07515fffff",639,1173,1812
"5367",1970-01-01 19:30:00,"88a8a0751dfffff",279,555,834
"5368",1970-01-01 19:30:00,"88a8a07521fffff",876,1787,2663
"5369",1970-01-01 19:30:00,"88a8a07525fffff",504,1000,1504
"5370",1970-01-01 19:30:00,"88a8a0752bfffff",936,1890,2826
"5371",1970-01-01 19:30:00,"88a8a0752dfffff",876,1787,2663
"5372",1970-01-01 19:30:00,"88a8a07531fffff",1065,2279,3344
"5373",1970-01-01 19:30:00,"88a8a07533fffff",240,412,652
"5374",1970-01-01 19:30:00,"88a8a07535fffff",483,1155,1638
"5375",1970-01-01 19:30:00,"88a8a07537fffff",360,618,978
"5376",1970-01-01 19:30:00,"88a8a07539fffff",1023,2082,3105
"5377",1970-01-01 19:30:00,"88a8a0753bfffff",240,412,652
"5378",1970-01-01 19:30:00,"88a8a0753dfffff",501,1061,1562
"5379",1970-01-01 19:30:00,"88a8a07543fffff",531,974,1505
"5380",1970-01-01 19:30:00,"88a8a07545fffff",180,309,489
"5381",1970-01-01 19:30:00,"88a8a07547fffff",411,768,1179
"5382",1970-01-01 19:30:00,"88a8a07553fffff",168,302,470
"5383",1970-01-01 19:30:00,"88a8a07557fffff",219,452,671
"5384",1970-01-01 19:30:00,"88a8a07559fffff",651,1180,1831
"5385",1970-01-01 19:30:00,"88a8a0755bfffff",219,452,671
"5386",1970-01-01 19:30:00,"88a8a0755dfffff",651,1180,1831
"5387",1970-01-01 19:30:00,"88a8a07561fffff",657,1335,1992
"5388",1970-01-01 19:30:00,"88a8a07565fffff",153,450,603
"5389",1970-01-01 19:30:00,"88a8a07567fffff",774,1487,2261
"5390",1970-01-01 19:30:00,"88a8a07569fffff",471,871,1342
"5391",1970-01-01 19:30:00,"88a8a0756bfffff",300,515,815
"5392",1970-01-01 19:30:00,"88a8a0756dfffff",783,1555,2338
"5393",1970-01-01 19:30:00,"88a8a07633fffff",504,1115,1619
"5394",1970-01-01 19:30:00,"88a8a07637fffff",444,1012,1456
"5395",1970-01-01 19:30:00,"88a8a076c7fffff",344,711,1055
"5396",1970-01-01 19:30:00,"88a8a076d1fffff",284,608,892
"5397",1970-01-01 19:30:00,"88a8a076d3fffff",608,1299,1907
"5398",1970-01-01 19:30:00,"88a8a076d5fffff",497,1046,1543
"5399",1970-01-01 19:30:00,"88a8a076d7fffff",264,588,852
"5400",1970-01-01 19:30:00,"88a8a076e9fffff",557,1264,1821
"5401",1970-01-01 19:30:00,"88a8a076ebfffff",335,758,1093
"5402",1970-01-01 19:30:00,"88a8a076edfffff",455,964,1419
"5403",1970-01-01 20:00:00,"88a8a02801fffff",285,756,1041
"5404",1970-01-01 20:00:00,"88a8a02805fffff",132,306,438
"5405",1970-01-01 20:00:00,"88a8a02809fffff",195,532,727
"5406",1970-01-01 20:00:00,"88a8a0280bfffff",81,156,237
"5407",1970-01-01 20:00:00,"88a8a02825fffff",84,210,294
"5408",1970-01-01 20:00:00,"88a8a02829fffff",132,306,438
"5409",1970-01-01 20:00:00,"88a8a0282dfffff",132,306,438
"5410",1970-01-01 20:00:00,"88a8a02853fffff",99,246,345
"5411",1970-01-01 20:00:00,"88a8a02857fffff",132,306,438
"5412",1970-01-01 20:00:00,"88a8a02919fffff",84,210,294
"5413",1970-01-01 20:00:00,"88a8a0291dfffff",81,156,237
"5414",1970-01-01 20:00:00,"88a8a02953fffff",48,96,144
"5415",1970-01-01 20:00:00,"88a8a02957fffff",114,216,330
"5416",1970-01-01 20:00:00,"88a8a02a01fffff",162,403,565
"5417",1970-01-01 20:00:00,"88a8a02a05fffff",162,403,565
"5418",1970-01-01 20:00:00,"88a8a02a0dfffff",60,103,163
"5419",1970-01-01 20:00:00,"88a8a02a13fffff",60,103,163
"5420",1970-01-01 20:00:00,"88a8a02a57fffff",51,150,201
"5421",1970-01-01 20:00:00,"88a8a02a61fffff",60,103,163
"5422",1970-01-01 20:00:00,"88a8a02a63fffff",171,356,527
"5423",1970-01-01 20:00:00,"88a8a02a69fffff",111,253,364
"5424",1970-01-01 20:00:00,"88a8a02a89fffff",233,458,691
"5425",1970-01-01 20:00:00,"88a8a02a8bfffff",113,252,365
"5426",1970-01-01 20:00:00,"88a8a02a9dfffff",60,103,163
"5427",1970-01-01 20:00:00,"88a8a02aadfffff",150,396,546
"5428",1970-01-01 20:00:00,"88a8a02ac5fffff",180,309,489
"5429",1970-01-01 20:00:00,"88a8a02ac7fffff",284,608,892
"5430",1970-01-01 20:00:00,"88a8a02ad1fffff",0,0,0
"5431",1970-01-01 20:00:00,"88a8a02ad3fffff",0,0,0
"5432",1970-01-01 20:00:00,"88a8a02ad7fffff",0,0,0
"5433",1970-01-01 20:00:00,"88a8a02adbfffff",0,0,0
"5434",1970-01-01 20:00:00,"88a8a02ae3fffff",150,396,546
"5435",1970-01-01 20:00:00,"88a8a02ae7fffff",150,396,546
"5436",1970-01-01 20:00:00,"88a8a02aebfffff",102,300,402
"5437",1970-01-01 20:00:00,"88a8a03987fffff",402,815,1217
"5438",1970-01-01 20:00:00,"88a8a03995fffff",233,458,691
"5439",1970-01-01 20:00:00,"88a8a03997fffff",60,103,163
"5440",1970-01-01 20:00:00,"88a8a039a1fffff",563,1138,1701
"5441",1970-01-01 20:00:00,"88a8a039abfffff",572,1091,1663
"5442",1970-01-01 20:00:00,"88a8a039adfffff",623,1241,1864
"5443",1970-01-01 20:00:00,"88a8a039b9fffff",635,1273,1908
"5444",1970-01-01 20:00:00,"88a8a039bbfffff",522,1021,1543
"5445",1970-01-01 20:00:00,"88a8a039bdfffff",279,530,809
"5446",1970-01-01 20:00:00,"88a8a06081fffff",42,82,124
"5447",1970-01-01 20:00:00,"88a8a06085fffff",561,1420,1981
"5448",1970-01-01 20:00:00,"88a8a0608dfffff",561,1305,1866
"5449",1970-01-01 20:00:00,"88a8a060a3fffff",345,916,1261
"5450",1970-01-01 20:00:00,"88a8a060a7fffff",42,82,124
"5451",1970-01-01 20:00:00,"88a8a060abfffff",396,1066,1462
"5452",1970-01-01 20:00:00,"88a8a060c1fffff",93,232,325
"5453",1970-01-01 20:00:00,"88a8a060c3fffff",366,888,1254
"5454",1970-01-01 20:00:00,"88a8a060c7fffff",324,806,1130
"5455",1970-01-01 20:00:00,"88a8a060cbfffff",363,834,1197
"5456",1970-01-01 20:00:00,"88a8a06193fffff",396,1066,1462
"5457",1970-01-01 20:00:00,"88a8a06197fffff",297,832,1129
"5458",1970-01-01 20:00:00,"88a8a0619bfffff",243,616,859
"5459",1970-01-01 20:00:00,"88a8a061a1fffff",102,300,402
"5460",1970-01-01 20:00:00,"88a8a061a3fffff",201,534,735
"5461",1970-01-01 20:00:00,"88a8a061a5fffff",153,450,603
"5462",1970-01-01 20:00:00,"88a8a061b1fffff",153,450,603
"5463",1970-01-01 20:00:00,"88a8a061b3fffff",347,915,1262
"5464",1970-01-01 20:00:00,"88a8a061b5fffff",396,1066,1462
"5465",1970-01-01 20:00:00,"88a8a061b7fffff",356,983,1339
"5466",1970-01-01 20:00:00,"88a8a06249fffff",522,1021,1543
"5467",1970-01-01 20:00:00,"88a8a0624bfffff",582,1124,1706
"5468",1970-01-01 20:00:00,"88a8a0624dfffff",642,1227,1869
"5469",1970-01-01 20:00:00,"88a8a06281fffff",141,328,469
"5470",1970-01-01 20:00:00,"88a8a06283fffff",411,930,1341
"5471",1970-01-01 20:00:00,"88a8a06287fffff",351,827,1178
"5472",1970-01-01 20:00:00,"88a8a06289fffff",417,829,1246
"5473",1970-01-01 20:00:00,"88a8a0628bfffff",198,492,690
"5474",1970-01-01 20:00:00,"88a8a06293fffff",120,206,326
"5475",1970-01-01 20:00:00,"88a8a06299fffff",180,309,489
"5476",1970-01-01 20:00:00,"88a8a0629bfffff",120,206,326
"5477",1970-01-01 20:00:00,"88a8a062b5fffff",363,834,1197
"5478",1970-01-01 20:00:00,"88a8a062bdfffff",423,937,1360
"5479",1970-01-01 20:00:00,"88a8a062c1fffff",108,199,307
"5480",1970-01-01 20:00:00,"88a8a062c3fffff",375,747,1122
"5481",1970-01-01 20:00:00,"88a8a062cbfffff",375,747,1122
"5482",1970-01-01 20:00:00,"88a8a062d1fffff",240,412,652
"5483",1970-01-01 20:00:00,"88a8a062d3fffff",180,309,489
"5484",1970-01-01 20:00:00,"88a8a062d9fffff",300,515,815
"5485",1970-01-01 20:00:00,"88a8a06541fffff",240,412,652
"5486",1970-01-01 20:00:00,"88a8a06549fffff",360,618,978
"5487",1970-01-01 20:00:00,"88a8a06705fffff",360,618,978
"5488",1970-01-01 20:00:00,"88a8a06707fffff",240,412,652
"5489",1970-01-01 20:00:00,"88a8a0670dfffff",240,412,652
"5490",1970-01-01 20:00:00,"88a8a0672bfffff",180,309,489
"5491",1970-01-01 20:00:00,"88a8a06731fffff",240,412,652
"5492",1970-01-01 20:00:00,"88a8a06735fffff",300,515,815
"5493",1970-01-01 20:00:00,"88a8a06739fffff",240,412,652
"5494",1970-01-01 20:00:00,"88a8a0674dfffff",180,309,489
"5495",1970-01-01 20:00:00,"88a8a0676bfffff",300,515,815
"5496",1970-01-01 20:00:00,"88a8a06a91fffff",51,150,201
"5497",1970-01-01 20:00:00,"88a8a06a9bfffff",51,150,201
"5498",1970-01-01 20:00:00,"88a8a06e49fffff",252,684,936
"5499",1970-01-01 20:00:00,"88a8a06e4dfffff",345,916,1261
"5500",1970-01-01 20:00:00,"88a8a06e69fffff",51,150,201
"5501",1970-01-01 20:00:00,"88a8a06e6dfffff",398,1065,1463
"5502",1970-01-01 20:00:00,"88a8a06f05fffff",51,150,201
"5503",1970-01-01 20:00:00,"88a8a06f61fffff",51,150,201
"5504",1970-01-01 20:00:00,"88a8a06f63fffff",102,300,402
"5505",1970-01-01 20:00:00,"88a8a06f67fffff",51,150,201
"5506",1970-01-01 20:00:00,"88a8a06f69fffff",51,150,201
"5507",1970-01-01 20:00:00,"88a8a070b3fffff",702,1330,2032
"5508",1970-01-01 20:00:00,"88a8a070b7fffff",582,1124,1706
"5509",1970-01-01 20:00:00,"88a8a0719bfffff",411,768,1179
"5510",1970-01-01 20:00:00,"88a8a07441fffff",653,1406,2059
"5511",1970-01-01 20:00:00,"88a8a07445fffff",494,1082,1576
"5512",1970-01-01 20:00:00,"88a8a07447fffff",212,473,685
"5513",1970-01-01 20:00:00,"88a8a0744bfffff",605,1335,1940
"5514",1970-01-01 20:00:00,"88a8a07461fffff",1025,2056,3081
"5515",1970-01-01 20:00:00,"88a8a07465fffff",794,1482,2276
"5516",1970-01-01 20:00:00,"88a8a07467fffff",120,206,326
"5517",1970-01-01 20:00:00,"88a8a07469fffff",180,309,489
"5518",1970-01-01 20:00:00,"88a8a0746bfffff",953,1921,2874
"5519",1970-01-01 20:00:00,"88a8a07503fffff",180,309,489
"5520",1970-01-01 20:00:00,"88a8a07507fffff",687,1269,1956
"5521",1970-01-01 20:00:00,"88a8a07515fffff",420,721,1141
"5522",1970-01-01 20:00:00,"88a8a0751dfffff",120,206,326
"5523",1970-01-01 20:00:00,"88a8a07521fffff",756,1325,2081
"5524",1970-01-01 20:00:00,"88a8a07525fffff",276,501,777
"5525",1970-01-01 20:00:00,"88a8a0752bfffff",756,1325,2081
"5526",1970-01-01 20:00:00,"88a8a0752dfffff",687,1269,1956
"5527",1970-01-01 20:00:00,"88a8a07531fffff",1086,2030,3116
"5528",1970-01-01 20:00:00,"88a8a07533fffff",240,412,652
"5529",1970-01-01 20:00:00,"88a8a07535fffff",327,651,978
"5530",1970-01-01 20:00:00,"88a8a07537fffff",360,618,978
"5531",1970-01-01 20:00:00,"88a8a07539fffff",609,1145,1754
"5532",1970-01-01 20:00:00,"88a8a0753bfffff",60,103,163
"5533",1970-01-01 20:00:00,"88a8a0753dfffff",450,796,1246
"5534",1970-01-01 20:00:00,"88a8a07543fffff",575,1170,1745
"5535",1970-01-01 20:00:00,"88a8a07545fffff",524,1020,1544
"5536",1970-01-01 20:00:00,"88a8a07547fffff",755,1479,2234
"5537",1970-01-01 20:00:00,"88a8a07553fffff",180,309,489
"5538",1970-01-01 20:00:00,"88a8a07557fffff",180,309,489
"5539",1970-01-01 20:00:00,"88a8a07559fffff",695,1376,2071
"5540",1970-01-01 20:00:00,"88a8a0755bfffff",231,459,690
"5541",1970-01-01 20:00:00,"88a8a0755dfffff",755,1479,2234
"5542",1970-01-01 20:00:00,"88a8a07561fffff",627,1166,1793
"5543",1970-01-01 20:00:00,"88a8a07565fffff",180,309,489
"5544",1970-01-01 20:00:00,"88a8a07567fffff",687,1269,1956
"5545",1970-01-01 20:00:00,"88a8a07569fffff",815,1582,2397
"5546",1970-01-01 20:00:00,"88a8a0756bfffff",575,1170,1745
"5547",1970-01-01 20:00:00,"88a8a0756dfffff",1208,2329,3537
"5548",1970-01-01 20:00:00,"88a8a07633fffff",561,1139,1700
"5549",1970-01-01 20:00:00,"88a8a07637fffff",506,1114,1620
"5550",1970-01-01 20:00:00,"88a8a076c7fffff",162,403,565
"5551",1970-01-01 20:00:00,"88a8a076d1fffff",351,665,1016
"5552",1970-01-01 20:00:00,"88a8a076d3fffff",519,942,1461
"5553",1970-01-01 20:00:00,"88a8a076d5fffff",381,715,1096
"5554",1970-01-01 20:00:00,"88a8a076d7fffff",108,174,282
"5555",1970-01-01 20:00:00,"88a8a076e9fffff",222,506,728
"5556",1970-01-01 20:00:00,"88a8a076ebfffff",162,403,565
"5557",1970-01-01 20:00:00,"88a8a076edfffff",282,609,891
"5558",1970-01-01 20:30:00,"88a8a02801fffff",99,246,345
"5559",1970-01-01 20:30:00,"88a8a02805fffff",99,246,345
"5560",1970-01-01 20:30:00,"88a8a02809fffff",0,0,0
"5561",1970-01-01 20:30:00,"88a8a0280bfffff",51,150,201
"5562",1970-01-01 20:30:00,"88a8a02825fffff",99,246,345
"5563",1970-01-01 20:30:00,"88a8a02829fffff",99,246,345
"5564",1970-01-01 20:30:00,"88a8a0282dfffff",99,246,345
"5565",1970-01-01 20:30:00,"88a8a02853fffff",132,306,438
"5566",1970-01-01 20:30:00,"88a8a02857fffff",150,396,546
"5567",1970-01-01 20:30:00,"88a8a02919fffff",48,96,144
"5568",1970-01-01 20:30:00,"88a8a02953fffff",48,96,144
"5569",1970-01-01 20:30:00,"88a8a02a01fffff",99,221,320
"5570",1970-01-01 20:30:00,"88a8a02a05fffff",102,300,402
"5571",1970-01-01 20:30:00,"88a8a02a0bfffff",51,150,201
"5572",1970-01-01 20:30:00,"88a8a02a0dfffff",51,150,201
"5573",1970-01-01 20:30:00,"88a8a02a11fffff",321,727,1048
"5574",1970-01-01 20:30:00,"88a8a02a13fffff",270,577,847
"5575",1970-01-01 20:30:00,"88a8a02a19fffff",321,727,1048
"5576",1970-01-01 20:30:00,"88a8a02a1dfffff",48,71,119
"5577",1970-01-01 20:30:00,"88a8a02a57fffff",261,624,885
"5578",1970-01-01 20:30:00,"88a8a02a61fffff",102,300,402
"5579",1970-01-01 20:30:00,"88a8a02a63fffff",153,450,603
"5580",1970-01-01 20:30:00,"88a8a02a69fffff",222,506,728
"5581",1970-01-01 20:30:00,"88a8a02a89fffff",342,780,1122
"5582",1970-01-01 20:30:00,"88a8a02a8bfffff",402,883,1285
"5583",1970-01-01 20:30:00,"88a8a02a9dfffff",201,337,538
"5584",1970-01-01 20:30:00,"88a8a02aadfffff",132,306,438
"5585",1970-01-01 20:30:00,"88a8a02ac5fffff",261,624,885
"5586",1970-01-01 20:30:00,"88a8a02ac7fffff",411,1020,1431
"5587",1970-01-01 20:30:00,"88a8a02ae3fffff",234,606,840
"5588",1970-01-01 20:30:00,"88a8a02ae7fffff",183,456,639
"5589",1970-01-01 20:30:00,"88a8a02aebfffff",183,456,639
"5590",1970-01-01 20:30:00,"88a8a03987fffff",284,608,892
"5591",1970-01-01 20:30:00,"88a8a03995fffff",60,103,163
"5592",1970-01-01 20:30:00,"88a8a03997fffff",275,655,930
"5593",1970-01-01 20:30:00,"88a8a039a1fffff",464,917,1381
"5594",1970-01-01 20:30:00,"88a8a039abfffff",464,917,1381
"5595",1970-01-01 20:30:00,"88a8a039adfffff",515,1067,1582
"5596",1970-01-01 20:30:00,"88a8a039b9fffff",353,664,1017
"5597",1970-01-01 20:30:00,"88a8a039bbfffff",281,529,810
"5598",1970-01-01 20:30:00,"88a8a039bdfffff",180,309,489
"5599",1970-01-01 20:30:00,"88a8a06081fffff",42,82,124
"5600",1970-01-01 20:30:00,"88a8a06085fffff",582,1218,1800
"5601",1970-01-01 20:30:00,"88a8a0608dfffff",809,1683,2492
"5602",1970-01-01 20:30:00,"88a8a060a3fffff",342,759,1101
"5603",1970-01-01 20:30:00,"88a8a060a7fffff",150,281,431
"5604",1970-01-01 20:30:00,"88a8a060abfffff",333,691,1024
"5605",1970-01-01 20:30:00,"88a8a060c3fffff",378,686,1064
"5606",1970-01-01 20:30:00,"88a8a060c7fffff",480,986,1466
"5607",1970-01-01 20:30:00,"88a8a060cbfffff",429,951,1380
"5608",1970-01-01 20:30:00,"88a8a06193fffff",336,745,1081
"5609",1970-01-01 20:30:00,"88a8a06197fffff",234,560,794
"5610",1970-01-01 20:30:00,"88a8a0619bfffff",138,274,412
"5611",1970-01-01 20:30:00,"88a8a061a1fffff",493,1296,1789
"5612",1970-01-01 20:30:00,"88a8a061a3fffff",445,1212,1657
"5613",1970-01-01 20:30:00,"88a8a061a5fffff",491,1297,1788
"5614",1970-01-01 20:30:00,"88a8a061b1fffff",144,382,526
"5615",1970-01-01 20:30:00,"88a8a061b3fffff",288,764,1052
"5616",1970-01-01 20:30:00,"88a8a061b5fffff",394,1062,1456
"5617",1970-01-01 20:30:00,"88a8a061b7fffff",135,314,449
"5618",1970-01-01 20:30:00,"88a8a06249fffff",651,1180,1831
"5619",1970-01-01 20:30:00,"88a8a0624bfffff",651,1180,1831
"5620",1970-01-01 20:30:00,"88a8a0624dfffff",591,1077,1668
"5621",1970-01-01 20:30:00,"88a8a06281fffff",222,506,728
"5622",1970-01-01 20:30:00,"88a8a06283fffff",434,1004,1438
"5623",1970-01-01 20:30:00,"88a8a06287fffff",390,808,1198
"5624",1970-01-01 20:30:00,"88a8a06289fffff",446,1011,1457
"5625",1970-01-01 20:30:00,"88a8a0628bfffff",162,403,565
"5626",1970-01-01 20:30:00,"88a8a06293fffff",240,412,652
"5627",1970-01-01 20:30:00,"88a8a06299fffff",180,309,489
"5628",1970-01-01 20:30:00,"88a8a0629bfffff",240,412,652
"5629",1970-01-01 20:30:00,"88a8a062b5fffff",378,801,1179
"5630",1970-01-01 20:30:00,"88a8a062bdfffff",378,801,1179
"5631",1970-01-01 20:30:00,"88a8a062c1fffff",215,552,767
"5632",1970-01-01 20:30:00,"88a8a062c3fffff",326,805,1131
"5633",1970-01-01 20:30:00,"88a8a062cbfffff",383,854,1237
"5634",1970-01-01 20:30:00,"88a8a062d1fffff",360,618,978
"5635",1970-01-01 20:30:00,"88a8a062d3fffff",180,309,489
"5636",1970-01-01 20:30:00,"88a8a062d9fffff",360,618,978
"5637",1970-01-01 20:30:00,"88a8a06541fffff",60,103,163
"5638",1970-01-01 20:30:00,"88a8a06705fffff",300,515,815
"5639",1970-01-01 20:30:00,"88a8a06707fffff",240,412,652
"5640",1970-01-01 20:30:00,"88a8a0672bfffff",180,309,489
"5641",1970-01-01 20:30:00,"88a8a06731fffff",180,309,489
"5642",1970-01-01 20:30:00,"88a8a06735fffff",240,412,652
"5643",1970-01-01 20:30:00,"88a8a06739fffff",240,412,652
"5644",1970-01-01 20:30:00,"88a8a0673dfffff",60,103,163
"5645",1970-01-01 20:30:00,"88a8a0674dfffff",120,206,326
"5646",1970-01-01 20:30:00,"88a8a0676bfffff",60,103,163
"5647",1970-01-01 20:30:00,"88a8a06a91fffff",99,234,333
"5648",1970-01-01 20:30:00,"88a8a06a9bfffff",99,234,333
"5649",1970-01-01 20:30:00,"88a8a06e49fffff",252,581,833
"5650",1970-01-01 20:30:00,"88a8a06e4dfffff",342,759,1101
"5651",1970-01-01 20:30:00,"88a8a06e69fffff",51,150,201
"5652",1970-01-01 20:30:00,"88a8a06e6dfffff",288,764,1052
"5653",1970-01-01 20:30:00,"88a8a06f05fffff",48,84,132
"5654",1970-01-01 20:30:00,"88a8a06f61fffff",96,168,264
"5655",1970-01-01 20:30:00,"88a8a06f63fffff",96,168,264
"5656",1970-01-01 20:30:00,"88a8a06f67fffff",96,168,264
"5657",1970-01-01 20:30:00,"88a8a06f69fffff",48,84,132
"5658",1970-01-01 20:30:00,"88a8a070b3fffff",411,768,1179
"5659",1970-01-01 20:30:00,"88a8a070b7fffff",591,1077,1668
"5660",1970-01-01 20:30:00,"88a8a0719bfffff",411,768,1179
"5661",1970-01-01 20:30:00,"88a8a07441fffff",706,1440,2146
"5662",1970-01-01 20:30:00,"88a8a07445fffff",314,658,972
"5663",1970-01-01 20:30:00,"88a8a07447fffff",512,988,1500
"5664",1970-01-01 20:30:00,"88a8a0744bfffff",526,1131,1657
"5665",1970-01-01 20:30:00,"88a8a07461fffff",1138,2193,3331
"5666",1970-01-01 20:30:00,"88a8a07465fffff",919,1881,2800
"5667",1970-01-01 20:30:00,"88a8a07467fffff",180,309,489
"5668",1970-01-01 20:30:00,"88a8a07469fffff",60,103,163
"5669",1970-01-01 20:30:00,"88a8a0746bfffff",951,1930,2881
"5670",1970-01-01 20:30:00,"88a8a07503fffff",60,103,163
"5671",1970-01-01 20:30:00,"88a8a07507fffff",813,1583,2396
"5672",1970-01-01 20:30:00,"88a8a07515fffff",531,974,1505
"5673",1970-01-01 20:30:00,"88a8a0751dfffff",180,309,489
"5674",1970-01-01 20:30:00,"88a8a07521fffff",732,1520,2252
"5675",1970-01-01 20:30:00,"88a8a07525fffff",543,1143,1686
"5676",1970-01-01 20:30:00,"88a8a0752bfffff",792,1623,2415
"5677",1970-01-01 20:30:00,"88a8a0752dfffff",750,1426,2176
"5678",1970-01-01 20:30:00,"88a8a07531fffff",1094,2137,3231
"5679",1970-01-01 20:30:00,"88a8a07533fffff",240,412,652
"5680",1970-01-01 20:30:00,"88a8a07535fffff",434,1004,1438
"5681",1970-01-01 20:30:00,"88a8a07537fffff",360,618,978
"5682",1970-01-01 20:30:00,"88a8a07539fffff",732,1520,2252
"5683",1970-01-01 20:30:00,"88a8a0753bfffff",240,412,652
"5684",1970-01-01 20:30:00,"88a8a0753dfffff",390,808,1198
"5685",1970-01-01 20:30:00,"88a8a07543fffff",808,1628,2436
"5686",1970-01-01 20:30:00,"88a8a07545fffff",466,916,1382
"5687",1970-01-01 20:30:00,"88a8a07547fffff",748,1525,2273
"5688",1970-01-01 20:30:00,"88a8a07553fffff",233,458,691
"5689",1970-01-01 20:30:00,"88a8a07557fffff",233,458,691
"5690",1970-01-01 20:30:00,"88a8a07559fffff",748,1525,2273
"5691",1970-01-01 20:30:00,"88a8a0755bfffff",180,309,489
"5692",1970-01-01 20:30:00,"88a8a0755dfffff",688,1422,2110
"5693",1970-01-01 20:30:00,"88a8a07561fffff",849,1672,2521
"5694",1970-01-01 20:30:00,"88a8a07565fffff",240,412,652
"5695",1970-01-01 20:30:00,"88a8a07567fffff",861,1679,2540
"5696",1970-01-01 20:30:00,"88a8a07569fffff",568,1216,1784
"5697",1970-01-01 20:30:00,"88a8a0756bfffff",524,1020,1544
"5698",1970-01-01 20:30:00,"88a8a0756dfffff",1161,2194,3355
"5699",1970-01-01 20:30:00,"88a8a07633fffff",554,1070,1624
"5700",1970-01-01 20:30:00,"88a8a07637fffff",533,1085,1618
"5701",1970-01-01 20:30:00,"88a8a076c7fffff",108,174,282
"5702",1970-01-01 20:30:00,"88a8a076d1fffff",394,781,1175
"5703",1970-01-01 20:30:00,"88a8a076d3fffff",616,1287,1903
"5704",1970-01-01 20:30:00,"88a8a076d5fffff",565,1137,1702
"5705",1970-01-01 20:30:00,"88a8a076d7fffff",120,206,326
"5706",1970-01-01 20:30:00,"88a8a076e5fffff",60,103,163
"5707",1970-01-01 20:30:00,"88a8a076e9fffff",452,885,1337
"5708",1970-01-01 20:30:00,"88a8a076ebfffff",228,380,608
"5709",1970-01-01 20:30:00,"88a8a076edfffff",392,782,1174
"5710",1970-01-01 21:00:00,"88a8a02801fffff",234,581,815
"5711",1970-01-01 21:00:00,"88a8a02805fffff",33,60,93
"5712",1970-01-01 21:00:00,"88a8a02809fffff",99,221,320
"5713",1970-01-01 21:00:00,"88a8a0280bfffff",33,60,93
"5714",1970-01-01 21:00:00,"88a8a02829fffff",135,360,495
"5715",1970-01-01 21:00:00,"88a8a0282dfffff",102,300,402
"5716",1970-01-01 21:00:00,"88a8a02853fffff",33,60,93
"5717",1970-01-01 21:00:00,"88a8a02857fffff",33,60,93
"5718",1970-01-01 21:00:00,"88a8a02919fffff",51,150,201
"5719",1970-01-01 21:00:00,"88a8a0291dfffff",51,150,201
"5720",1970-01-01 21:00:00,"88a8a02953fffff",102,300,402
"5721",1970-01-01 21:00:00,"88a8a02957fffff",102,300,402
"5722",1970-01-01 21:00:00,"88a8a02a01fffff",219,427,646
"5723",1970-01-01 21:00:00,"88a8a02a05fffff",309,580,889
"5724",1970-01-01 21:00:00,"88a8a02a0bfffff",48,71,119
"5725",1970-01-01 21:00:00,"88a8a02a0dfffff",108,174,282
"5726",1970-01-01 21:00:00,"88a8a02a11fffff",48,71,119
"5727",1970-01-01 21:00:00,"88a8a02a13fffff",99,221,320
"5728",1970-01-01 21:00:00,"88a8a02a19fffff",48,71,119
"5729",1970-01-01 21:00:00,"88a8a02a61fffff",219,427,646
"5730",1970-01-01 21:00:00,"88a8a02a63fffff",272,576,848
"5731",1970-01-01 21:00:00,"88a8a02a69fffff",374,761,1135
"5732",1970-01-01 21:00:00,"88a8a02a6bfffff",102,185,287
"5733",1970-01-01 21:00:00,"88a8a02a6dfffff",53,149,202
"5734",1970-01-01 21:00:00,"88a8a02a89fffff",192,384,576
"5735",1970-01-01 21:00:00,"88a8a02a8bfffff",192,384,576
"5736",1970-01-01 21:00:00,"88a8a02a9dfffff",201,546,747
"5737",1970-01-01 21:00:00,"88a8a02aadfffff",81,131,212
"5738",1970-01-01 21:00:00,"88a8a02ac5fffff",48,71,119
"5739",1970-01-01 21:00:00,"88a8a02ac7fffff",240,455,695
"5740",1970-01-01 21:00:00,"88a8a02ae3fffff",81,131,212
"5741",1970-01-01 21:00:00,"88a8a02ae7fffff",81,131,212
"5742",1970-01-01 21:00:00,"88a8a02aebfffff",81,131,212
"5743",1970-01-01 21:00:00,"88a8a03987fffff",339,633,972
"5744",1970-01-01 21:00:00,"88a8a03995fffff",326,690,1016
"5745",1970-01-01 21:00:00,"88a8a03997fffff",425,911,1336
"5746",1970-01-01 21:00:00,"88a8a039a1fffff",605,1220,1825
"5747",1970-01-01 21:00:00,"88a8a039abfffff",665,1323,1988
"5748",1970-01-01 21:00:00,"88a8a039adfffff",605,1220,1825
"5749",1970-01-01 21:00:00,"88a8a039b9fffff",665,1323,1988
"5750",1970-01-01 21:00:00,"88a8a039bbfffff",485,1014,1499
"5751",1970-01-01 21:00:00,"88a8a039bdfffff",215,437,652
"5752",1970-01-01 21:00:00,"88a8a06081fffff",51,150,201
"5753",1970-01-01 21:00:00,"88a8a06085fffff",522,1183,1705
"5754",1970-01-01 21:00:00,"88a8a0608dfffff",636,1490,2126
"5755",1970-01-01 21:00:00,"88a8a060a3fffff",252,581,833
"5756",1970-01-01 21:00:00,"88a8a060a7fffff",48,96,144
"5757",1970-01-01 21:00:00,"88a8a060abfffff",261,649,910
"5758",1970-01-01 21:00:00,"88a8a060c3fffff",270,602,872
"5759",1970-01-01 21:00:00,"88a8a060c7fffff",381,855,1236
"5760",1970-01-01 21:00:00,"88a8a060cbfffff",321,752,1073
"5761",1970-01-01 21:00:00,"88a8a06193fffff",302,676,978
"5762",1970-01-01 21:00:00,"88a8a06197fffff",194,465,659
"5763",1970-01-01 21:00:00,"88a8a0619bfffff",111,253,364
"5764",1970-01-01 21:00:00,"88a8a061a1fffff",327,686,1013
"5765",1970-01-01 21:00:00,"88a8a061a3fffff",327,686,1013
"5766",1970-01-01 21:00:00,"88a8a061a5fffff",327,686,1013
"5767",1970-01-01 21:00:00,"88a8a061b1fffff",341,692,1033
"5768",1970-01-01 21:00:00,"88a8a061b3fffff",491,1088,1579
"5769",1970-01-01 21:00:00,"88a8a061b5fffff",396,857,1253
"5770",1970-01-01 21:00:00,"88a8a061b7fffff",599,1275,1874
"5771",1970-01-01 21:00:00,"88a8a06249fffff",513,1068,1581
"5772",1970-01-01 21:00:00,"88a8a0624bfffff",633,1274,1907
"5773",1970-01-01 21:00:00,"88a8a0624dfffff",453,965,1418
"5774",1970-01-01 21:00:00,"88a8a06281fffff",210,499,709
"5775",1970-01-01 21:00:00,"88a8a06283fffff",372,902,1274
"5776",1970-01-01 21:00:00,"88a8a06287fffff",321,752,1073
"5777",1970-01-01 21:00:00,"88a8a06289fffff",201,546,747
"5778",1970-01-01 21:00:00,"88a8a0628bfffff",51,150,201
"5779",1970-01-01 21:00:00,"88a8a06293fffff",60,103,163
"5780",1970-01-01 21:00:00,"88a8a06299fffff",120,206,326
"5781",1970-01-01 21:00:00,"88a8a0629bfffff",120,206,326
"5782",1970-01-01 21:00:00,"88a8a062b5fffff",321,752,1073
"5783",1970-01-01 21:00:00,"88a8a062bdfffff",321,752,1073
"5784",1970-01-01 21:00:00,"88a8a062c3fffff",102,300,402
"5785",1970-01-01 21:00:00,"88a8a062cbfffff",102,300,402
"5786",1970-01-01 21:00:00,"88a8a062d1fffff",60,103,163
"5787",1970-01-01 21:00:00,"88a8a062d3fffff",120,206,326
"5788",1970-01-01 21:00:00,"88a8a062d9fffff",120,206,326
"5789",1970-01-01 21:00:00,"88a8a06541fffff",120,206,326
"5790",1970-01-01 21:00:00,"88a8a06549fffff",180,309,489
"5791",1970-01-01 21:00:00,"88a8a06705fffff",360,618,978
"5792",1970-01-01 21:00:00,"88a8a06707fffff",240,412,652
"5793",1970-01-01 21:00:00,"88a8a0670dfffff",180,309,489
"5794",1970-01-01 21:00:00,"88a8a0672bfffff",60,103,163
"5795",1970-01-01 21:00:00,"88a8a06731fffff",360,618,978
"5796",1970-01-01 21:00:00,"88a8a06735fffff",240,412,652
"5797",1970-01-01 21:00:00,"88a8a06739fffff",300,515,815
"5798",1970-01-01 21:00:00,"88a8a0673dfffff",120,206,326
"5799",1970-01-01 21:00:00,"88a8a0674dfffff",60,103,163
"5800",1970-01-01 21:00:00,"88a8a0676bfffff",360,618,978
"5801",1970-01-01 21:00:00,"88a8a06a91fffff",48,84,132
"5802",1970-01-01 21:00:00,"88a8a06a9bfffff",99,234,333
"5803",1970-01-01 21:00:00,"88a8a06e49fffff",144,382,526
"5804",1970-01-01 21:00:00,"88a8a06e4dfffff",204,485,689
"5805",1970-01-01 21:00:00,"88a8a06e69fffff",42,82,124
"5806",1970-01-01 21:00:00,"88a8a06e6dfffff",440,938,1378
"5807",1970-01-01 21:00:00,"88a8a06f05fffff",51,150,201
"5808",1970-01-01 21:00:00,"88a8a06f61fffff",51,150,201
"5809",1970-01-01 21:00:00,"88a8a06f63fffff",51,150,201
"5810",1970-01-01 21:00:00,"88a8a070b3fffff",762,1433,2195
"5811",1970-01-01 21:00:00,"88a8a070b7fffff",753,1480,2233
"5812",1970-01-01 21:00:00,"88a8a0719bfffff",231,459,690
"5813",1970-01-01 21:00:00,"88a8a07441fffff",572,1091,1663
"5814",1970-01-01 21:00:00,"88a8a07443fffff",60,103,163
"5815",1970-01-01 21:00:00,"88a8a07445fffff",339,633,972
"5816",1970-01-01 21:00:00,"88a8a07447fffff",341,632,973
"5817",1970-01-01 21:00:00,"88a8a0744bfffff",524,1020,1544
"5818",1970-01-01 21:00:00,"88a8a07461fffff",1022,1977,2999
"5819",1970-01-01 21:00:00,"88a8a07465fffff",521,941,1462
"5820",1970-01-01 21:00:00,"88a8a07467fffff",171,356,527
"5821",1970-01-01 21:00:00,"88a8a07469fffff",171,356,527
"5822",1970-01-01 21:00:00,"88a8a0746bfffff",671,1312,1983
"5823",1970-01-01 21:00:00,"88a8a07507fffff",291,562,853
"5824",1970-01-01 21:00:00,"88a8a07515fffff",351,665,1016
"5825",1970-01-01 21:00:00,"88a8a0751dfffff",282,609,891
"5826",1970-01-01 21:00:00,"88a8a07521fffff",513,953,1466
"5827",1970-01-01 21:00:00,"88a8a07525fffff",231,459,690
"5828",1970-01-01 21:00:00,"88a8a0752bfffff",462,918,1380
"5829",1970-01-01 21:00:00,"88a8a0752dfffff",402,815,1217
"5830",1970-01-01 21:00:00,"88a8a07531fffff",684,1424,2108
"5831",1970-01-01 21:00:00,"88a8a07535fffff",153,450,603
"5832",1970-01-01 21:00:00,"88a8a07537fffff",120,206,326
"5833",1970-01-01 21:00:00,"88a8a07539fffff",531,974,1505
"5834",1970-01-01 21:00:00,"88a8a0753bfffff",60,103,163
"5835",1970-01-01 21:00:00,"88a8a0753dfffff",120,206,326
"5836",1970-01-01 21:00:00,"88a8a07543fffff",533,973,1506
"5837",1970-01-01 21:00:00,"88a8a07545fffff",353,664,1017
"5838",1970-01-01 21:00:00,"88a8a07547fffff",533,973,1506
"5839",1970-01-01 21:00:00,"88a8a07553fffff",180,309,489
"5840",1970-01-01 21:00:00,"88a8a07557fffff",162,403,565
"5841",1970-01-01 21:00:00,"88a8a07559fffff",473,870,1343
"5842",1970-01-01 21:00:00,"88a8a0755bfffff",282,609,891
"5843",1970-01-01 21:00:00,"88a8a0755dfffff",593,1076,1669
"5844",1970-01-01 21:00:00,"88a8a07561fffff",351,665,1016
"5845",1970-01-01 21:00:00,"88a8a07565fffff",120,206,326
"5846",1970-01-01 21:00:00,"88a8a07567fffff",462,918,1380
"5847",1970-01-01 21:00:00,"88a8a07569fffff",653,1179,1832
"5848",1970-01-01 21:00:00,"88a8a0756bfffff",473,870,1343
"5849",1970-01-01 21:00:00,"88a8a0756dfffff",916,1687,2603
"5850",1970-01-01 21:00:00,"88a8a07633fffff",293,561,854
"5851",1970-01-01 21:00:00,"88a8a07637fffff",455,964,1419
"5852",1970-01-01 21:00:00,"88a8a076c7fffff",173,355,528
"5853",1970-01-01 21:00:00,"88a8a076d1fffff",455,964,1419
"5854",1970-01-01 21:00:00,"88a8a076d3fffff",677,1355,2032
"5855",1970-01-01 21:00:00,"88a8a076d5fffff",462,918,1380
"5856",1970-01-01 21:00:00,"88a8a076d7fffff",120,206,326
"5857",1970-01-01 21:00:00,"88a8a076e9fffff",275,540,815
"5858",1970-01-01 21:00:00,"88a8a076ebfffff",155,334,489
"5859",1970-01-01 21:00:00,"88a8a076edfffff",335,643,978
"5860",1970-01-01 21:30:00,"88a8a02801fffff",81,131,212
"5861",1970-01-01 21:30:00,"88a8a02805fffff",33,60,93
"5862",1970-01-01 21:30:00,"88a8a02809fffff",102,300,402
"5863",1970-01-01 21:30:00,"88a8a0280bfffff",84,210,294
"5864",1970-01-01 21:30:00,"88a8a02825fffff",33,60,93
"5865",1970-01-01 21:30:00,"88a8a02829fffff",33,60,93
"5866",1970-01-01 21:30:00,"88a8a0282dfffff",66,120,186
"5867",1970-01-01 21:30:00,"88a8a02853fffff",84,210,294
"5868",1970-01-01 21:30:00,"88a8a02857fffff",84,210,294
"5869",1970-01-01 21:30:00,"88a8a02919fffff",33,60,93
"5870",1970-01-01 21:30:00,"88a8a0291dfffff",33,60,93
"5871",1970-01-01 21:30:00,"88a8a02953fffff",33,60,93
"5872",1970-01-01 21:30:00,"88a8a02957fffff",66,120,186
"5873",1970-01-01 21:30:00,"88a8a02a01fffff",215,437,652
"5874",1970-01-01 21:30:00,"88a8a02a05fffff",224,505,729
"5875",1970-01-01 21:30:00,"88a8a02a11fffff",102,300,402
"5876",1970-01-01 21:30:00,"88a8a02a13fffff",102,300,402
"5877",1970-01-01 21:30:00,"88a8a02a19fffff",102,300,402
"5878",1970-01-01 21:30:00,"88a8a02a57fffff",102,300,402
"5879",1970-01-01 21:30:00,"88a8a02a61fffff",51,150,201
"5880",1970-01-01 21:30:00,"88a8a02a63fffff",171,356,527
"5881",1970-01-01 21:30:00,"88a8a02a69fffff",204,485,689
"5882",1970-01-01 21:30:00,"88a8a02a89fffff",318,673,991
"5883",1970-01-01 21:30:00,"88a8a02a8bfffff",378,776,1154
"5884",1970-01-01 21:30:00,"88a8a02a9dfffff",168,277,445
"5885",1970-01-01 21:30:00,"88a8a02aadfffff",84,210,294
"5886",1970-01-01 21:30:00,"88a8a02ac5fffff",153,450,603
"5887",1970-01-01 21:30:00,"88a8a02ac7fffff",261,649,910
"5888",1970-01-01 21:30:00,"88a8a02ae3fffff",99,246,345
"5889",1970-01-01 21:30:00,"88a8a02ae7fffff",99,246,345
"5890",1970-01-01 21:30:00,"88a8a02aebfffff",99,246,345
"5891",1970-01-01 21:30:00,"88a8a03987fffff",282,494,776
"5892",1970-01-01 21:30:00,"88a8a03995fffff",120,206,326
"5893",1970-01-01 21:30:00,"88a8a03997fffff",266,587,853
"5894",1970-01-01 21:30:00,"88a8a039a1fffff",608,1299,1907
"5895",1970-01-01 21:30:00,"88a8a039abfffff",668,1402,2070
"5896",1970-01-01 21:30:00,"88a8a039adfffff",608,1299,1907
"5897",1970-01-01 21:30:00,"88a8a039b9fffff",515,952,1467
"5898",1970-01-01 21:30:00,"88a8a039bbfffff",506,999,1505
"5899",1970-01-01 21:30:00,"88a8a039bdfffff",233,458,691
"5900",1970-01-01 21:30:00,"88a8a06081fffff",60,103,163
"5901",1970-01-01 21:30:00,"88a8a06085fffff",429,939,1368
"5902",1970-01-01 21:30:00,"88a8a0608dfffff",489,1042,1531
"5903",1970-01-01 21:30:00,"88a8a060a3fffff",260,582,842
"5904",1970-01-01 21:30:00,"88a8a060a7fffff",99,246,345
"5905",1970-01-01 21:30:00,"88a8a060abfffff",201,546,747
"5906",1970-01-01 21:30:00,"88a8a060c1fffff",104,299,403
"5907",1970-01-01 21:30:00,"88a8a060c3fffff",297,717,1014
"5908",1970-01-01 21:30:00,"88a8a060c7fffff",528,1176,1704
"5909",1970-01-01 21:30:00,"88a8a060cbfffff",377,840,1217
"5910",1970-01-01 21:30:00,"88a8a06193fffff",309,733,1042
"5911",1970-01-01 21:30:00,"88a8a06197fffff",321,752,1073
"5912",1970-01-01 21:30:00,"88a8a061a1fffff",257,749,1006
"5913",1970-01-01 21:30:00,"88a8a061a3fffff",206,599,805
"5914",1970-01-01 21:30:00,"88a8a061a5fffff",299,831,1130
"5915",1970-01-01 21:30:00,"88a8a061b1fffff",374,901,1275
"5916",1970-01-01 21:30:00,"88a8a061b3fffff",372,902,1274
"5917",1970-01-01 21:30:00,"88a8a061b5fffff",257,749,1006
"5918",1970-01-01 21:30:00,"88a8a061b7fffff",365,948,1313
"5919",1970-01-01 21:30:00,"88a8a06213fffff",0,0,0
"5920",1970-01-01 21:30:00,"88a8a06249fffff",540,927,1467
"5921",1970-01-01 21:30:00,"88a8a0624bfffff",600,1030,1630
"5922",1970-01-01 21:30:00,"88a8a0624dfffff",660,1133,1793
"5923",1970-01-01 21:30:00,"88a8a06281fffff",255,520,775
"5924",1970-01-01 21:30:00,"88a8a06283fffff",257,519,776
"5925",1970-01-01 21:30:00,"88a8a06287fffff",266,587,853
"5926",1970-01-01 21:30:00,"88a8a06289fffff",315,623,938
"5927",1970-01-01 21:30:00,"88a8a0628bfffff",111,253,364
"5928",1970-01-01 21:30:00,"88a8a06293fffff",120,206,326
"5929",1970-01-01 21:30:00,"88a8a06299fffff",60,103,163
"5930",1970-01-01 21:30:00,"88a8a062b5fffff",264,588,852
"5931",1970-01-01 21:30:00,"88a8a062bdfffff",377,840,1217
"5932",1970-01-01 21:30:00,"88a8a062c1fffff",213,438,651
"5933",1970-01-01 21:30:00,"88a8a062c3fffff",324,691,1015
"5934",1970-01-01 21:30:00,"88a8a062c5fffff",0,0,0
"5935",1970-01-01 21:30:00,"88a8a062c7fffff",0,0,0
"5936",1970-01-01 21:30:00,"88a8a062cbfffff",366,773,1139
"5937",1970-01-01 21:30:00,"88a8a062d1fffff",60,103,163
"5938",1970-01-01 21:30:00,"88a8a062d3fffff",60,103,163
"5939",1970-01-01 21:30:00,"88a8a062d9fffff",180,309,489
"5940",1970-01-01 21:30:00,"88a8a06705fffff",120,206,326
"5941",1970-01-01 21:30:00,"88a8a06707fffff",60,103,163
"5942",1970-01-01 21:30:00,"88a8a0670dfffff",60,103,163
"5943",1970-01-01 21:30:00,"88a8a0672bfffff",60,103,163
"5944",1970-01-01 21:30:00,"88a8a06731fffff",60,103,163
"5945",1970-01-01 21:30:00,"88a8a06735fffff",60,103,163
"5946",1970-01-01 21:30:00,"88a8a06739fffff",60,103,163
"5947",1970-01-01 21:30:00,"88a8a0674dfffff",120,206,326
"5948",1970-01-01 21:30:00,"88a8a0676bfffff",120,206,326
"5949",1970-01-01 21:30:00,"88a8a06a91fffff",51,150,201
"5950",1970-01-01 21:30:00,"88a8a06a9bfffff",51,150,201
"5951",1970-01-01 21:30:00,"88a8a06e49fffff",161,336,497
"5952",1970-01-01 21:30:00,"88a8a06e4dfffff",311,732,1043
"5953",1970-01-01 21:30:00,"88a8a06e69fffff",210,499,709
"5954",1970-01-01 21:30:00,"88a8a06e6dfffff",372,902,1274
"5955",1970-01-01 21:30:00,"88a8a06f05fffff",51,150,201
"5956",1970-01-01 21:30:00,"88a8a06f61fffff",51,150,201
"5957",1970-01-01 21:30:00,"88a8a06f63fffff",102,300,402
"5958",1970-01-01 21:30:00,"88a8a06f67fffff",51,150,201
"5959",1970-01-01 21:30:00,"88a8a06f69fffff",102,300,402
"5960",1970-01-01 21:30:00,"88a8a070b3fffff",411,768,1179
"5961",1970-01-01 21:30:00,"88a8a070b7fffff",540,927,1467
"5962",1970-01-01 21:30:00,"88a8a0719bfffff",240,412,652
"5963",1970-01-01 21:30:00,"88a8a07441fffff",383,829,1212
"5964",1970-01-01 21:30:00,"88a8a07445fffff",383,829,1212
"5965",1970-01-01 21:30:00,"88a8a07447fffff",221,426,647
"5966",1970-01-01 21:30:00,"88a8a0744bfffff",282,609,891
"5967",1970-01-01 21:30:00,"88a8a07461fffff",866,1732,2598
"5968",1970-01-01 21:30:00,"88a8a07465fffff",626,1320,1946
"5969",1970-01-01 21:30:00,"88a8a07467fffff",240,412,652
"5970",1970-01-01 21:30:00,"88a8a07469fffff",120,206,326
"5971",1970-01-01 21:30:00,"88a8a0746bfffff",794,1597,2391
"5972",1970-01-01 21:30:00,"88a8a07507fffff",915,1653,2568
"5973",1970-01-01 21:30:00,"88a8a07515fffff",480,824,1304
"5974",1970-01-01 21:30:00,"88a8a0751dfffff",300,515,815
"5975",1970-01-01 21:30:00,"88a8a07521fffff",1053,1880,2933
"5976",1970-01-01 21:30:00,"88a8a07525fffff",684,1309,1993
"5977",1970-01-01 21:30:00,"88a8a0752bfffff",873,1571,2444
"5978",1970-01-01 21:30:00,"88a8a0752dfffff",1164,2133,3297
"5979",1970-01-01 21:30:00,"88a8a07531fffff",1095,1962,3057
"5980",1970-01-01 21:30:00,"88a8a07533fffff",120,206,326
"5981",1970-01-01 21:30:00,"88a8a07535fffff",315,623,938
"5982",1970-01-01 21:30:00,"88a8a07537fffff",180,309,489
"5983",1970-01-01 21:30:00,"88a8a07539fffff",873,1571,2444
"5984",1970-01-01 21:30:00,"88a8a0753bfffff",180,309,489
"5985",1970-01-01 21:30:00,"88a8a0753dfffff",351,665,1016
"5986",1970-01-01 21:30:00,"88a8a07543fffff",522,1021,1543
"5987",1970-01-01 21:30:00,"88a8a07545fffff",464,917,1381
"5988",1970-01-01 21:30:00,"88a8a07547fffff",566,1217,1783
"5989",1970-01-01 21:30:00,"88a8a07553fffff",240,412,652
"5990",1970-01-01 21:30:00,"88a8a07557fffff",240,412,652
"5991",1970-01-01 21:30:00,"88a8a07559fffff",686,1423,2109
"5992",1970-01-01 21:30:00,"88a8a0755bfffff",240,412,652
"5993",1970-01-01 21:30:00,"88a8a0755dfffff",566,1217,1783
"5994",1970-01-01 21:30:00,"88a8a07561fffff",1071,1901,2972
"5995",1970-01-01 21:30:00,"88a8a07567fffff",1053,1880,2933
"5996",1970-01-01 21:30:00,"88a8a07569fffff",619,1366,1985
"5997",1970-01-01 21:30:00,"88a8a0756bfffff",395,861,1256
"5998",1970-01-01 21:30:00,"88a8a0756dfffff",1368,2733,4101
"5999",1970-01-01 21:30:00,"88a8a07633fffff",390,783,1173
"6000",1970-01-01 21:30:00,"88a8a07637fffff",342,712,1054
"6001",1970-01-01 21:30:00,"88a8a076c7fffff",162,403,565
"6002",1970-01-01 21:30:00,"88a8a076d1fffff",291,562,853
"6003",1970-01-01 21:30:00,"88a8a076d3fffff",393,747,1140
"6004",1970-01-01 21:30:00,"88a8a076d5fffff",333,644,977
"6005",1970-01-01 21:30:00,"88a8a076d7fffff",171,356,527
"6006",1970-01-01 21:30:00,"88a8a076e9fffff",450,886,1336
"6007",1970-01-01 21:30:00,"88a8a076ebfffff",222,506,728
"6008",1970-01-01 21:30:00,"88a8a076edfffff",342,712,1054
"6009",1970-01-01 22:00:00,"88a8a02801fffff",48,96,144
"6010",1970-01-01 22:00:00,"88a8a02805fffff",48,96,144
"6011",1970-01-01 22:00:00,"88a8a02809fffff",0,0,0
"6012",1970-01-01 22:00:00,"88a8a0280bfffff",48,96,144
"6013",1970-01-01 22:00:00,"88a8a02829fffff",48,96,144
"6014",1970-01-01 22:00:00,"88a8a0282dfffff",48,96,144
"6015",1970-01-01 22:00:00,"88a8a02853fffff",48,96,144
"6016",1970-01-01 22:00:00,"88a8a02857fffff",48,96,144
"6017",1970-01-01 22:00:00,"88a8a0291dfffff",48,96,144
"6018",1970-01-01 22:00:00,"88a8a02953fffff",48,96,144
"6019",1970-01-01 22:00:00,"88a8a02957fffff",48,96,144
"6020",1970-01-01 22:00:00,"88a8a02a01fffff",326,805,1131
"6021",1970-01-01 22:00:00,"88a8a02a05fffff",323,726,1049
"6022",1970-01-01 22:00:00,"88a8a02a0bfffff",60,103,163
"6023",1970-01-01 22:00:00,"88a8a02a11fffff",60,103,163
"6024",1970-01-01 22:00:00,"88a8a02a13fffff",0,0,0
"6025",1970-01-01 22:00:00,"88a8a02a19fffff",120,206,326
"6026",1970-01-01 22:00:00,"88a8a02a57fffff",120,206,326
"6027",1970-01-01 22:00:00,"88a8a02a61fffff",224,505,729
"6028",1970-01-01 22:00:00,"88a8a02a63fffff",224,505,729
"6029",1970-01-01 22:00:00,"88a8a02a69fffff",434,979,1413
"6030",1970-01-01 22:00:00,"88a8a02a89fffff",141,234,375
"6031",1970-01-01 22:00:00,"88a8a02a8bfffff",141,234,375
"6032",1970-01-01 22:00:00,"88a8a02a9dfffff",33,60,93
"6033",1970-01-01 22:00:00,"88a8a02aa9fffff",33,60,93
"6034",1970-01-01 22:00:00,"88a8a02aadfffff",48,96,144
"6035",1970-01-01 22:00:00,"88a8a02ac5fffff",120,206,326
"6036",1970-01-01 22:00:00,"88a8a02ac7fffff",201,337,538
"6037",1970-01-01 22:00:00,"88a8a02ae3fffff",33,60,93
"6038",1970-01-01 22:00:00,"88a8a02aebfffff",33,60,93
"6039",1970-01-01 22:00:00,"88a8a03987fffff",222,506,728
"6040",1970-01-01 22:00:00,"88a8a03995fffff",231,459,690
"6041",1970-01-01 22:00:00,"88a8a03997fffff",377,955,1332
"6042",1970-01-01 22:00:00,"88a8a039a1fffff",436,978,1414
"6043",1970-01-01 22:00:00,"88a8a039abfffff",434,979,1413
"6044",1970-01-01 22:00:00,"88a8a039adfffff",595,1302,1897
"6045",1970-01-01 22:00:00,"88a8a039b9fffff",437,1058,1495
"6046",1970-01-01 22:00:00,"88a8a039bbfffff",437,1058,1495
"6047",1970-01-01 22:00:00,"88a8a039bdfffff",51,150,201
"6048",1970-01-01 22:00:00,"88a8a06081fffff",60,103,163
"6049",1970-01-01 22:00:00,"88a8a06085fffff",252,569,821
"6050",1970-01-01 22:00:00,"88a8a0608dfffff",333,644,977
"6051",1970-01-01 22:00:00,"88a8a060a3fffff",159,337,496
"6052",1970-01-01 22:00:00,"88a8a060a7fffff",48,84,132
"6053",1970-01-01 22:00:00,"88a8a060abfffff",159,337,496
"6054",1970-01-01 22:00:00,"88a8a060c1fffff",111,253,364
"6055",1970-01-01 22:00:00,"88a8a060c3fffff",231,459,690
"6056",1970-01-01 22:00:00,"88a8a060c7fffff",231,459,690
"6057",1970-01-01 22:00:00,"88a8a060cbfffff",273,541,814
"6058",1970-01-01 22:00:00,"88a8a06193fffff",210,487,697
"6059",1970-01-01 22:00:00,"88a8a06197fffff",102,300,402
"6060",1970-01-01 22:00:00,"88a8a0619bfffff",99,234,333
"6061",1970-01-01 22:00:00,"88a8a061a1fffff",192,478,670
"6062",1970-01-01 22:00:00,"88a8a061a3fffff",243,628,871
"6063",1970-01-01 22:00:00,"88a8a061a5fffff",201,546,747
"6064",1970-01-01 22:00:00,"88a8a061b3fffff",252,569,821
"6065",1970-01-01 22:00:00,"88a8a061b5fffff",240,562,802
"6066",1970-01-01 22:00:00,"88a8a061b7fffff",192,466,658
"6067",1970-01-01 22:00:00,"88a8a06249fffff",300,515,815
"6068",1970-01-01 22:00:00,"88a8a0624bfffff",300,515,815
"6069",1970-01-01 22:00:00,"88a8a0624dfffff",300,515,815
"6070",1970-01-01 22:00:00,"88a8a06281fffff",224,505,729
"6071",1970-01-01 22:00:00,"88a8a06283fffff",333,644,977
"6072",1970-01-01 22:00:00,"88a8a06287fffff",351,665,1016
"6073",1970-01-01 22:00:00,"88a8a06289fffff",386,793,1179
"6074",1970-01-01 22:00:00,"88a8a0628bfffff",111,253,364
"6075",1970-01-01 22:00:00,"88a8a06293fffff",180,309,489
"6076",1970-01-01 22:00:00,"88a8a06299fffff",240,412,652
"6077",1970-01-01 22:00:00,"88a8a0629bfffff",180,309,489
"6078",1970-01-01 22:00:00,"88a8a062b5fffff",213,438,651
"6079",1970-01-01 22:00:00,"88a8a062bdfffff",273,541,814
"6080",1970-01-01 22:00:00,"88a8a062c1fffff",120,206,326
"6081",1970-01-01 22:00:00,"88a8a062c3fffff",275,540,815
"6082",1970-01-01 22:00:00,"88a8a062cbfffff",233,458,691
"6083",1970-01-01 22:00:00,"88a8a062d1fffff",180,309,489
"6084",1970-01-01 22:00:00,"88a8a062d3fffff",240,412,652
"6085",1970-01-01 22:00:00,"88a8a062d5fffff",0,0,0
"6086",1970-01-01 22:00:00,"88a8a062d7fffff",0,0,0
"6087",1970-01-01 22:00:00,"88a8a062d9fffff",180,309,489
"6088",1970-01-01 22:00:00,"88a8a06541fffff",120,206,326
"6089",1970-01-01 22:00:00,"88a8a06549fffff",180,309,489
"6090",1970-01-01 22:00:00,"88a8a06705fffff",300,515,815
"6091",1970-01-01 22:00:00,"88a8a06707fffff",180,309,489
"6092",1970-01-01 22:00:00,"88a8a0670dfffff",180,309,489
"6093",1970-01-01 22:00:00,"88a8a0672bfffff",60,103,163
"6094",1970-01-01 22:00:00,"88a8a06731fffff",240,412,652
"6095",1970-01-01 22:00:00,"88a8a06735fffff",240,412,652
"6096",1970-01-01 22:00:00,"88a8a06739fffff",240,412,652
"6097",1970-01-01 22:00:00,"88a8a0673dfffff",60,103,163
"6098",1970-01-01 22:00:00,"88a8a0674dfffff",180,309,489
"6099",1970-01-01 22:00:00,"88a8a0676bfffff",180,309,489
"6100",1970-01-01 22:00:00,"88a8a06a91fffff",51,150,201
"6101",1970-01-01 22:00:00,"88a8a06a9bfffff",51,150,201
"6102",1970-01-01 22:00:00,"88a8a06e49fffff",111,253,364
"6103",1970-01-01 22:00:00,"88a8a06e4dfffff",210,487,697
"6104",1970-01-01 22:00:00,"88a8a06e69fffff",108,187,295
"6105",1970-01-01 22:00:00,"88a8a06e6dfffff",252,569,821
"6106",1970-01-01 22:00:00,"88a8a06f63fffff",51,150,201
"6107",1970-01-01 22:00:00,"88a8a06f69fffff",51,150,201
"6108",1970-01-01 22:00:00,"88a8a070b3fffff",300,515,815
"6109",1970-01-01 22:00:00,"88a8a070b7fffff",300,515,815
"6110",1970-01-01 22:00:00,"88a8a0719bfffff",240,412,652
"6111",1970-01-01 22:00:00,"88a8a07441fffff",574,1090,1664
"6112",1970-01-01 22:00:00,"88a8a07443fffff",48,71,119
"6113",1970-01-01 22:00:00,"88a8a07445fffff",240,412,652
"6114",1970-01-01 22:00:00,"88a8a07447fffff",233,458,691
"6115",1970-01-01 22:00:00,"88a8a0744bfffff",442,852,1294
"6116",1970-01-01 22:00:00,"88a8a07461fffff",757,1478,2235
"6117",1970-01-01 22:00:00,"88a8a07465fffff",739,1457,2196
"6118",1970-01-01 22:00:00,"88a8a07467fffff",120,206,326
"6119",1970-01-01 22:00:00,"88a8a07469fffff",60,103,163
"6120",1970-01-01 22:00:00,"88a8a0746bfffff",586,1122,1708
"6121",1970-01-01 22:00:00,"88a8a07507fffff",831,1489,2320
"6122",1970-01-01 22:00:00,"88a8a07515fffff",240,412,652
"6123",1970-01-01 22:00:00,"88a8a0751dfffff",120,206,326
"6124",1970-01-01 22:00:00,"88a8a07521fffff",644,1226,1870
"6125",1970-01-01 22:00:00,"88a8a07525fffff",344,711,1055
"6126",1970-01-01 22:00:00,"88a8a0752bfffff",764,1432,2196
"6127",1970-01-01 22:00:00,"88a8a0752dfffff",824,1535,2359
"6128",1970-01-01 22:00:00,"88a8a07531fffff",1073,1900,2973
"6129",1970-01-01 22:00:00,"88a8a07533fffff",180,309,489
"6130",1970-01-01 22:00:00,"88a8a07535fffff",233,458,691
"6131",1970-01-01 22:00:00,"88a8a07537fffff",120,206,326
"6132",1970-01-01 22:00:00,"88a8a07539fffff",824,1535,2359
"6133",1970-01-01 22:00:00,"88a8a0753dfffff",584,1123,1707
"6134",1970-01-01 22:00:00,"88a8a07543fffff",679,1354,2033
"6135",1970-01-01 22:00:00,"88a8a07545fffff",515,952,1467
"6136",1970-01-01 22:00:00,"88a8a07547fffff",799,1560,2359
"6137",1970-01-01 22:00:00,"88a8a07553fffff",120,206,326
"6138",1970-01-01 22:00:00,"88a8a07557fffff",60,103,163
"6139",1970-01-01 22:00:00,"88a8a07559fffff",679,1354,2033
"6140",1970-01-01 22:00:00,"88a8a0755bfffff",120,206,326
"6141",1970-01-01 22:00:00,"88a8a0755dfffff",730,1504,2234
"6142",1970-01-01 22:00:00,"88a8a07561fffff",824,1535,2359
"6143",1970-01-01 22:00:00,"88a8a07565fffff",171,356,527
"6144",1970-01-01 22:00:00,"88a8a07567fffff",653,1179,1832
"6145",1970-01-01 22:00:00,"88a8a07569fffff",695,1261,1956
"6146",1970-01-01 22:00:00,"88a8a0756bfffff",353,664,1017
"6147",1970-01-01 22:00:00,"88a8a0756dfffff",748,1410,2158
"6148",1970-01-01 22:00:00,"88a8a07633fffff",553,1105,1658
"6149",1970-01-01 22:00:00,"88a8a07637fffff",442,852,1294
"6150",1970-01-01 22:00:00,"88a8a076c7fffff",265,622,887
"6151",1970-01-01 22:00:00,"88a8a076d1fffff",387,704,1091
"6152",1970-01-01 22:00:00,"88a8a076d3fffff",639,1498,2137
"6153",1970-01-01 22:00:00,"88a8a076d5fffff",379,954,1333
"6154",1970-01-01 22:00:00,"88a8a076d7fffff",357,889,1246
"6155",1970-01-01 22:00:00,"88a8a076e9fffff",373,796,1169
"6156",1970-01-01 22:00:00,"88a8a076ebfffff",164,402,566
"6157",1970-01-01 22:00:00,"88a8a076edfffff",373,796,1169
"6158",1970-01-01 22:30:00,"88a8a02801fffff",132,306,438
"6159",1970-01-01 22:30:00,"88a8a02805fffff",33,60,93
"6160",1970-01-01 22:30:00,"88a8a02809fffff",0,0,0
"6161",1970-01-01 22:30:00,"88a8a0280bfffff",129,227,356
"6162",1970-01-01 22:30:00,"88a8a02825fffff",48,96,144
"6163",1970-01-01 22:30:00,"88a8a02829fffff",81,156,237
"6164",1970-01-01 22:30:00,"88a8a0282dfffff",81,156,237
"6165",1970-01-01 22:30:00,"88a8a02853fffff",129,227,356
"6166",1970-01-01 22:30:00,"88a8a02857fffff",129,227,356
"6167",1970-01-01 22:30:00,"88a8a02919fffff",48,96,144
"6168",1970-01-01 22:30:00,"88a8a02953fffff",33,60,93
"6169",1970-01-01 22:30:00,"88a8a02957fffff",81,156,237
"6170",1970-01-01 22:30:00,"88a8a02a01fffff",161,323,484
"6171",1970-01-01 22:30:00,"88a8a02a05fffff",281,529,810
"6172",1970-01-01 22:30:00,"88a8a02a0bfffff",53,149,202
"6173",1970-01-01 22:30:00,"88a8a02a11fffff",152,370,522
"6174",1970-01-01 22:30:00,"88a8a02a13fffff",251,591,842
"6175",1970-01-01 22:30:00,"88a8a02a19fffff",200,441,641
"6176",1970-01-01 22:30:00,"88a8a02a57fffff",99,221,320
"6177",1970-01-01 22:30:00,"88a8a02a61fffff",168,277,445
"6178",1970-01-01 22:30:00,"88a8a02a63fffff",221,426,647
"6179",1970-01-01 22:30:00,"88a8a02a69fffff",281,529,810
"6180",1970-01-01 22:30:00,"88a8a02a6bfffff",60,103,163
"6181",1970-01-01 22:30:00,"88a8a02a89fffff",310,714,1024
"6182",1970-01-01 22:30:00,"88a8a02a8bfffff",310,714,1024
"6183",1970-01-01 22:30:00,"88a8a02a9dfffff",226,504,730
"6184",1970-01-01 22:30:00,"88a8a02aa9fffff",48,71,119
"6185",1970-01-01 22:30:00,"88a8a02aadfffff",132,281,413
"6186",1970-01-01 22:30:00,"88a8a02ac5fffff",323,726,1049
"6187",1970-01-01 22:30:00,"88a8a02ac7fffff",409,960,1369
"6188",1970-01-01 22:30:00,"88a8a02ae3fffff",180,377,557
"6189",1970-01-01 22:30:00,"88a8a02ae7fffff",84,210,294
"6190",1970-01-01 22:30:00,"88a8a02aebfffff",185,455,640
"6191",1970-01-01 22:30:00,"88a8a03987fffff",180,309,489
"6192",1970-01-01 22:30:00,"88a8a03995fffff",108,174,282
"6193",1970-01-01 22:30:00,"88a8a03997fffff",281,529,810
"6194",1970-01-01 22:30:00,"88a8a039a1fffff",228,380,608
"6195",1970-01-01 22:30:00,"88a8a039abfffff",341,632,973
"6196",1970-01-01 22:30:00,"88a8a039adfffff",348,586,934
"6197",1970-01-01 22:30:00,"88a8a039b9fffff",447,807,1254
"6198",1970-01-01 22:30:00,"88a8a039bbfffff",512,988,1500
"6199",1970-01-01 22:30:00,"88a8a039bdfffff",156,245,401
"6200",1970-01-01 22:30:00,"88a8a06085fffff",264,703,967
"6201",1970-01-01 22:30:00,"88a8a0608dfffff",504,1115,1619
"6202",1970-01-01 22:30:00,"88a8a060a3fffff",102,300,402
"6203",1970-01-01 22:30:00,"88a8a060abfffff",153,450,603
"6204",1970-01-01 22:30:00,"88a8a060c1fffff",102,300,402
"6205",1970-01-01 22:30:00,"88a8a060c3fffff",162,403,565
"6206",1970-01-01 22:30:00,"88a8a060c7fffff",162,403,565
"6207",1970-01-01 22:30:00,"88a8a060cbfffff",162,403,565
"6208",1970-01-01 22:30:00,"88a8a06193fffff",153,450,603
"6209",1970-01-01 22:30:00,"88a8a06197fffff",153,450,603
"6210",1970-01-01 22:30:00,"88a8a0619bfffff",51,150,201
"6211",1970-01-01 22:30:00,"88a8a061a1fffff",150,384,534
"6212",1970-01-01 22:30:00,"88a8a061a3fffff",99,234,333
"6213",1970-01-01 22:30:00,"88a8a061a5fffff",192,466,658
"6214",1970-01-01 22:30:00,"88a8a061b1fffff",102,300,402
"6215",1970-01-01 22:30:00,"88a8a061b3fffff",153,450,603
"6216",1970-01-01 22:30:00,"88a8a061b5fffff",102,300,402
"6217",1970-01-01 22:30:00,"88a8a061b7fffff",153,450,603
"6218",1970-01-01 22:30:00,"88a8a06249fffff",360,618,978
"6219",1970-01-01 22:30:00,"88a8a0624bfffff",360,618,978
"6220",1970-01-01 22:30:00,"88a8a0624dfffff",300,515,815
"6221",1970-01-01 22:30:00,"88a8a06281fffff",102,185,287
"6222",1970-01-01 22:30:00,"88a8a06283fffff",264,588,852
"6223",1970-01-01 22:30:00,"88a8a06287fffff",162,403,565
"6224",1970-01-01 22:30:00,"88a8a06289fffff",264,588,852
"6225",1970-01-01 22:30:00,"88a8a0628bfffff",162,403,565
"6226",1970-01-01 22:30:00,"88a8a06293fffff",120,206,326
"6227",1970-01-01 22:30:00,"88a8a06299fffff",180,309,489
"6228",1970-01-01 22:30:00,"88a8a0629bfffff",120,206,326
"6229",1970-01-01 22:30:00,"88a8a062b5fffff",111,253,364
"6230",1970-01-01 22:30:00,"88a8a062bdfffff",144,382,526
"6231",1970-01-01 22:30:00,"88a8a062c1fffff",213,553,766
"6232",1970-01-01 22:30:00,"88a8a062c3fffff",213,438,651
"6233",1970-01-01 22:30:00,"88a8a062cbfffff",366,773,1139
"6234",1970-01-01 22:30:00,"88a8a062d1fffff",60,103,163
"6235",1970-01-01 22:30:00,"88a8a062d3fffff",120,206,326
"6236",1970-01-01 22:30:00,"88a8a062d9fffff",240,412,652
"6237",1970-01-01 22:30:00,"88a8a06541fffff",60,103,163
"6238",1970-01-01 22:30:00,"88a8a06549fffff",60,103,163
"6239",1970-01-01 22:30:00,"88a8a06705fffff",120,206,326
"6240",1970-01-01 22:30:00,"88a8a06707fffff",60,103,163
"6241",1970-01-01 22:30:00,"88a8a0670dfffff",60,103,163
"6242",1970-01-01 22:30:00,"88a8a0672bfffff",60,103,163
"6243",1970-01-01 22:30:00,"88a8a06731fffff",60,103,163
"6244",1970-01-01 22:30:00,"88a8a06735fffff",60,103,163
"6245",1970-01-01 22:30:00,"88a8a06739fffff",60,103,163
"6246",1970-01-01 22:30:00,"88a8a0674dfffff",120,206,326
"6247",1970-01-01 22:30:00,"88a8a0676bfffff",120,206,326
"6248",1970-01-01 22:30:00,"88a8a06a91fffff",189,412,601
"6249",1970-01-01 22:30:00,"88a8a06a9bfffff",288,658,946
"6250",1970-01-01 22:30:00,"88a8a06e49fffff",102,300,402
"6251",1970-01-01 22:30:00,"88a8a06e4dfffff",153,450,603
"6252",1970-01-01 22:30:00,"88a8a06e6dfffff",153,450,603
"6253",1970-01-01 22:30:00,"88a8a06f05fffff",48,84,132
"6254",1970-01-01 22:30:00,"88a8a06f63fffff",96,168,264
"6255",1970-01-01 22:30:00,"88a8a06f67fffff",96,168,264
"6256",1970-01-01 22:30:00,"88a8a06f69fffff",48,84,132
"6257",1970-01-01 22:30:00,"88a8a070b3fffff",300,515,815
"6258",1970-01-01 22:30:00,"88a8a070b7fffff",300,515,815
"6259",1970-01-01 22:30:00,"88a8a0719bfffff",120,206,326
"6260",1970-01-01 22:30:00,"88a8a07441fffff",282,609,891
"6261",1970-01-01 22:30:00,"88a8a07445fffff",162,403,565
"6262",1970-01-01 22:30:00,"88a8a07447fffff",222,506,728
"6263",1970-01-01 22:30:00,"88a8a0744bfffff",282,609,891
"6264",1970-01-01 22:30:00,"88a8a07461fffff",462,918,1380
"6265",1970-01-01 22:30:00,"88a8a07465fffff",282,609,891
"6266",1970-01-01 22:30:00,"88a8a07467fffff",60,103,163
"6267",1970-01-01 22:30:00,"88a8a07469fffff",120,206,326
"6268",1970-01-01 22:30:00,"88a8a0746bfffff",393,862,1255
"6269",1970-01-01 22:30:00,"88a8a07503fffff",60,103,163
"6270",1970-01-01 22:30:00,"88a8a07507fffff",1095,1962,3057
"6271",1970-01-01 22:30:00,"88a8a07515fffff",240,412,652
"6272",1970-01-01 22:30:00,"88a8a0751dfffff",60,103,163
"6273",1970-01-01 22:30:00,"88a8a07521fffff",1053,1880,2933
"6274",1970-01-01 22:30:00,"88a8a07525fffff",762,1318,2080
"6275",1970-01-01 22:30:00,"88a8a0752bfffff",993,1777,2770
"6276",1970-01-01 22:30:00,"88a8a0752dfffff",1035,1859,2894
"6277",1970-01-01 22:30:00,"88a8a07531fffff",1506,2730,4236
"6278",1970-01-01 22:30:00,"88a8a07535fffff",375,841,1216
"6279",1970-01-01 22:30:00,"88a8a07537fffff",180,309,489
"6280",1970-01-01 22:30:00,"88a8a07539fffff",1215,2168,3383
"6281",1970-01-01 22:30:00,"88a8a0753bfffff",120,206,326
"6282",1970-01-01 22:30:00,"88a8a0753dfffff",642,1112,1754
"6283",1970-01-01 22:30:00,"88a8a07543fffff",333,759,1092
"6284",1970-01-01 22:30:00,"88a8a07545fffff",213,553,766
"6285",1970-01-01 22:30:00,"88a8a07547fffff",222,506,728
"6286",1970-01-01 22:30:00,"88a8a07553fffff",60,103,163
"6287",1970-01-01 22:30:00,"88a8a07557fffff",60,103,163
"6288",1970-01-01 22:30:00,"88a8a07559fffff",282,609,891
"6289",1970-01-01 22:30:00,"88a8a0755bfffff",120,206,326
"6290",1970-01-01 22:30:00,"88a8a0755dfffff",333,759,1092
"6291",1970-01-01 22:30:00,"88a8a07561fffff",873,1571,2444
"6292",1970-01-01 22:30:00,"88a8a07565fffff",60,103,163
"6293",1970-01-01 22:30:00,"88a8a07567fffff",993,1777,2770
"6294",1970-01-01 22:30:00,"88a8a07569fffff",264,703,967
"6295",1970-01-01 22:30:00,"88a8a0756bfffff",222,506,728
"6296",1970-01-01 22:30:00,"88a8a0756dfffff",984,1939,2923
"6297",1970-01-01 22:30:00,"88a8a07633fffff",120,206,326
"6298",1970-01-01 22:30:00,"88a8a07637fffff",222,506,728
"6299",1970-01-01 22:30:00,"88a8a076c7fffff",60,103,163
"6300",1970-01-01 22:30:00,"88a8a076d1fffff",228,380,608
"6301",1970-01-01 22:30:00,"88a8a076d3fffff",408,689,1097
"6302",1970-01-01 22:30:00,"88a8a076d5fffff",288,483,771
"6303",1970-01-01 22:30:00,"88a8a076d7fffff",108,174,282
"6304",1970-01-01 22:30:00,"88a8a076e9fffff",120,206,326
"6305",1970-01-01 22:30:00,"88a8a076ebfffff",60,103,163
"6306",1970-01-01 22:30:00,"88a8a076edfffff",120,206,326
"6307",1970-01-01 23:00:00,"88a8a02801fffff",132,281,413
"6308",1970-01-01 23:00:00,"88a8a02805fffff",33,60,93
"6309",1970-01-01 23:00:00,"88a8a02809fffff",152,370,522
"6310",1970-01-01 23:00:00,"88a8a0280bfffff",185,455,640
"6311",1970-01-01 23:00:00,"88a8a02825fffff",33,60,93
"6312",1970-01-01 23:00:00,"88a8a02829fffff",33,60,93
"6313",1970-01-01 23:00:00,"88a8a0282dfffff",33,60,93
"6314",1970-01-01 23:00:00,"88a8a02853fffff",134,305,439
"6315",1970-01-01 23:00:00,"88a8a02857fffff",185,455,640
"6316",1970-01-01 23:00:00,"88a8a02919fffff",33,60,93
"6317",1970-01-01 23:00:00,"88a8a0291dfffff",33,60,93
"6318",1970-01-01 23:00:00,"88a8a02957fffff",33,60,93
"6319",1970-01-01 23:00:00,"88a8a02a01fffff",222,506,728
"6320",1970-01-01 23:00:00,"88a8a02a05fffff",213,553,766
"6321",1970-01-01 23:00:00,"88a8a02a0bfffff",60,103,163
"6322",1970-01-01 23:00:00,"88a8a02a13fffff",60,103,163
"6323",1970-01-01 23:00:00,"88a8a02a19fffff",60,103,163
"6324",1970-01-01 23:00:00,"88a8a02a57fffff",120,206,326
"6325",1970-01-01 23:00:00,"88a8a02a61fffff",60,103,163
"6326",1970-01-01 23:00:00,"88a8a02a63fffff",213,553,766
"6327",1970-01-01 23:00:00,"88a8a02a69fffff",273,656,929
"6328",1970-01-01 23:00:00,"88a8a02a6bfffff",51,150,201
"6329",1970-01-01 23:00:00,"88a8a02a89fffff",156,295,451
"6330",1970-01-01 23:00:00,"88a8a02a8bfffff",156,295,451
"6331",1970-01-01 23:00:00,"88a8a02a9dfffff",108,199,307
"6332",1970-01-01 23:00:00,"88a8a02aadfffff",101,245,346
"6333",1970-01-01 23:00:00,"88a8a02ac7fffff",156,270,426
"6334",1970-01-01 23:00:00,"88a8a02ae3fffff",101,245,346
"6335",1970-01-01 23:00:00,"88a8a02ae7fffff",101,245,346
"6336",1970-01-01 23:00:00,"88a8a02aebfffff",48,96,144
"6337",1970-01-01 23:00:00,"88a8a03987fffff",102,300,402
"6338",1970-01-01 23:00:00,"88a8a03995fffff",60,103,163
"6339",1970-01-01 23:00:00,"88a8a03997fffff",231,459,690
"6340",1970-01-01 23:00:00,"88a8a039a1fffff",213,553,766
"6341",1970-01-01 23:00:00,"88a8a039abfffff",213,553,766
"6342",1970-01-01 23:00:00,"88a8a039adfffff",102,300,402
"6343",1970-01-01 23:00:00,"88a8a039b9fffff",273,656,929
"6344",1970-01-01 23:00:00,"88a8a039bbfffff",51,150,201
"6345",1970-01-01 23:00:00,"88a8a039bdfffff",51,150,201
"6346",1970-01-01 23:00:00,"88a8a06085fffff",153,335,488
"6347",1970-01-01 23:00:00,"88a8a0608dfffff",153,335,488
"6348",1970-01-01 23:00:00,"88a8a060a3fffff",153,335,488
"6349",1970-01-01 23:00:00,"88a8a060abfffff",102,185,287
"6350",1970-01-01 23:00:00,"88a8a060c1fffff",111,253,364
"6351",1970-01-01 23:00:00,"88a8a060c3fffff",213,438,651
"6352",1970-01-01 23:00:00,"88a8a060c7fffff",171,356,527
"6353",1970-01-01 23:00:00,"88a8a060cbfffff",213,438,651
"6354",1970-01-01 23:00:00,"88a8a06193fffff",204,485,689
"6355",1970-01-01 23:00:00,"88a8a06197fffff",111,253,364
"6356",1970-01-01 23:00:00,"88a8a0619bfffff",42,82,124
"6357",1970-01-01 23:00:00,"88a8a061a1fffff",204,600,804
"6358",1970-01-01 23:00:00,"88a8a061a3fffff",153,450,603
"6359",1970-01-01 23:00:00,"88a8a061a5fffff",390,958,1348
"6360",1970-01-01 23:00:00,"88a8a061b1fffff",51,150,201
"6361",1970-01-01 23:00:00,"88a8a061b3fffff",153,450,603
"6362",1970-01-01 23:00:00,"88a8a061b5fffff",102,300,402
"6363",1970-01-01 23:00:00,"88a8a061b7fffff",51,150,201
"6364",1970-01-01 23:00:00,"88a8a06249fffff",162,288,450
"6365",1970-01-01 23:00:00,"88a8a0624bfffff",162,288,450
"6366",1970-01-01 23:00:00,"88a8a0624dfffff",162,288,450
"6367",1970-01-01 23:00:00,"88a8a06281fffff",120,206,326
"6368",1970-01-01 23:00:00,"88a8a06283fffff",171,356,527
"6369",1970-01-01 23:00:00,"88a8a06287fffff",171,356,527
"6370",1970-01-01 23:00:00,"88a8a06289fffff",171,356,527
"6371",1970-01-01 23:00:00,"88a8a0628bfffff",60,103,163
"6372",1970-01-01 23:00:00,"88a8a06293fffff",60,103,163
"6373",1970-01-01 23:00:00,"88a8a0629bfffff",60,103,163
"6374",1970-01-01 23:00:00,"88a8a062b5fffff",324,691,1015
"6375",1970-01-01 23:00:00,"88a8a062bdfffff",231,459,690
"6376",1970-01-01 23:00:00,"88a8a062c3fffff",162,403,565
"6377",1970-01-01 23:00:00,"88a8a062cbfffff",222,506,728
"6378",1970-01-01 23:00:00,"88a8a062d1fffff",120,206,326
"6379",1970-01-01 23:00:00,"88a8a062d3fffff",120,206,326
"6380",1970-01-01 23:00:00,"88a8a062d9fffff",180,309,489
"6381",1970-01-01 23:00:00,"88a8a06541fffff",60,103,163
"6382",1970-01-01 23:00:00,"88a8a06549fffff",180,309,489
"6383",1970-01-01 23:00:00,"88a8a06705fffff",120,206,326
"6384",1970-01-01 23:00:00,"88a8a06707fffff",120,206,326
"6385",1970-01-01 23:00:00,"88a8a0670dfffff",60,103,163
"6386",1970-01-01 23:00:00,"88a8a0672bfffff",120,206,326
"6387",1970-01-01 23:00:00,"88a8a06731fffff",60,103,163
"6388",1970-01-01 23:00:00,"88a8a06735fffff",180,309,489
"6389",1970-01-01 23:00:00,"88a8a06739fffff",120,206,326
"6390",1970-01-01 23:00:00,"88a8a0674dfffff",60,103,163
"6391",1970-01-01 23:00:00,"88a8a0676bfffff",120,206,326
"6392",1970-01-01 23:00:00,"88a8a06a91fffff",293,711,1004
"6393",1970-01-01 23:00:00,"88a8a06a9bfffff",341,807,1148
"6394",1970-01-01 23:00:00,"88a8a06e49fffff",162,403,565
"6395",1970-01-01 23:00:00,"88a8a06e4dfffff",204,485,689
"6396",1970-01-01 23:00:00,"88a8a06e6dfffff",102,300,402
"6397",1970-01-01 23:00:00,"88a8a06f05fffff",51,150,201
"6398",1970-01-01 23:00:00,"88a8a06f63fffff",51,150,201
"6399",1970-01-01 23:00:00,"88a8a06f69fffff",48,84,132
"6400",1970-01-01 23:00:00,"88a8a070b3fffff",222,391,613
"6401",1970-01-01 23:00:00,"88a8a070b7fffff",162,288,450
"6402",1970-01-01 23:00:00,"88a8a0719bfffff",153,335,488
"6403",1970-01-01 23:00:00,"88a8a07441fffff",231,459,690
"6404",1970-01-01 23:00:00,"88a8a07443fffff",60,103,163
"6405",1970-01-01 23:00:00,"88a8a07445fffff",171,356,527
"6406",1970-01-01 23:00:00,"88a8a07447fffff",171,356,527
"6407",1970-01-01 23:00:00,"88a8a0744bfffff",231,459,690
"6408",1970-01-01 23:00:00,"88a8a07461fffff",180,309,489
"6409",1970-01-01 23:00:00,"88a8a07465fffff",120,206,326
"6410",1970-01-01 23:00:00,"88a8a07467fffff",60,103,163
"6411",1970-01-01 23:00:00,"88a8a07469fffff",60,103,163
"6412",1970-01-01 23:00:00,"88a8a0746bfffff",240,412,652
"6413",1970-01-01 23:00:00,"88a8a07503fffff",60,103,163
"6414",1970-01-01 23:00:00,"88a8a07507fffff",633,1274,1907
"6415",1970-01-01 23:00:00,"88a8a07515fffff",180,309,489
"6416",1970-01-01 23:00:00,"88a8a07521fffff",515,1067,1582
"6417",1970-01-01 23:00:00,"88a8a07525fffff",162,288,450
"6418",1970-01-01 23:00:00,"88a8a0752bfffff",566,1217,1783
"6419",1970-01-01 23:00:00,"88a8a0752dfffff",575,1170,1745
"6420",1970-01-01 23:00:00,"88a8a07531fffff",942,1742,2684
"6421",1970-01-01 23:00:00,"88a8a07533fffff",120,206,326
"6422",1970-01-01 23:00:00,"88a8a07535fffff",231,459,690
"6423",1970-01-01 23:00:00,"88a8a07537fffff",120,206,326
"6424",1970-01-01 23:00:00,"88a8a07539fffff",522,1021,1543
"6425",1970-01-01 23:00:00,"88a8a0753bfffff",60,103,163
"6426",1970-01-01 23:00:00,"88a8a0753dfffff",282,609,891
"6427",1970-01-01 23:00:00,"88a8a07543fffff",240,412,652
"6428",1970-01-01 23:00:00,"88a8a07545fffff",180,309,489
"6429",1970-01-01 23:00:00,"88a8a07547fffff",300,515,815
"6430",1970-01-01 23:00:00,"88a8a07553fffff",60,103,163
"6431",1970-01-01 23:00:00,"88a8a07557fffff",60,103,163
"6432",1970-01-01 23:00:00,"88a8a07559fffff",180,309,489
"6433",1970-01-01 23:00:00,"88a8a0755bfffff",60,103,163
"6434",1970-01-01 23:00:00,"88a8a0755dfffff",240,412,652
"6435",1970-01-01 23:00:00,"88a8a07561fffff",644,1226,1870
"6436",1970-01-01 23:00:00,"88a8a07565fffff",231,459,690
"6437",1970-01-01 23:00:00,"88a8a07567fffff",755,1479,2234
"6438",1970-01-01 23:00:00,"88a8a07569fffff",300,515,815
"6439",1970-01-01 23:00:00,"88a8a0756bfffff",120,206,326
"6440",1970-01-01 23:00:00,"88a8a0756dfffff",690,1298,1988
"6441",1970-01-01 23:00:00,"88a8a07633fffff",273,656,929
"6442",1970-01-01 23:00:00,"88a8a07637fffff",171,356,527
"6443",1970-01-01 23:00:00,"88a8a076c7fffff",153,450,603
"6444",1970-01-01 23:00:00,"88a8a076d1fffff",111,253,364
"6445",1970-01-01 23:00:00,"88a8a076d3fffff",111,253,364
"6446",1970-01-01 23:00:00,"88a8a076d5fffff",60,103,163
"6447",1970-01-01 23:00:00,"88a8a076d7fffff",60,103,163
"6448",1970-01-01 23:00:00,"88a8a076e9fffff",153,450,603
"6449",1970-01-01 23:00:00,"88a8a076ebfffff",153,450,603
"6450",1970-01-01 23:00:00,"88a8a076edfffff",213,553,766
"6451",1970-01-01 23:30:00,"88a8a02801fffff",150,396,546
"6452",1970-01-01 23:30:00,"88a8a02805fffff",48,96,144
"6453",1970-01-01 23:30:00,"88a8a02809fffff",198,442,640
"6454",1970-01-01 23:30:00,"88a8a0280bfffff",51,150,201
"6455",1970-01-01 23:30:00,"88a8a02825fffff",48,96,144
"6456",1970-01-01 23:30:00,"88a8a02829fffff",96,192,288
"6457",1970-01-01 23:30:00,"88a8a0282dfffff",96,192,288
"6458",1970-01-01 23:30:00,"88a8a02853fffff",0,0,0
"6459",1970-01-01 23:30:00,"88a8a02857fffff",0,0,0
"6460",1970-01-01 23:30:00,"88a8a02919fffff",48,96,144
"6461",1970-01-01 23:30:00,"88a8a0291dfffff",48,96,144
"6462",1970-01-01 23:30:00,"88a8a02953fffff",96,192,288
"6463",1970-01-01 23:30:00,"88a8a02957fffff",48,96,144
"6464",1970-01-01 23:30:00,"88a8a02a01fffff",222,506,728
"6465",1970-01-01 23:30:00,"88a8a02a05fffff",231,459,690
"6466",1970-01-01 23:30:00,"88a8a02a0bfffff",60,103,163
"6467",1970-01-01 23:30:00,"88a8a02a0dfffff",0,0,0
"6468",1970-01-01 23:30:00,"88a8a02a11fffff",53,149,202
"6469",1970-01-01 23:30:00,"88a8a02a13fffff",104,299,403
"6470",1970-01-01 23:30:00,"88a8a02a19fffff",113,252,365
"6471",1970-01-01 23:30:00,"88a8a02a57fffff",113,252,365
"6472",1970-01-01 23:30:00,"88a8a02a61fffff",51,150,201
"6473",1970-01-01 23:30:00,"88a8a02a63fffff",171,356,527
"6474",1970-01-01 23:30:00,"88a8a02a69fffff",171,356,527
"6475",1970-01-01 23:30:00,"88a8a02a6bfffff",60,103,163
"6476",1970-01-01 23:30:00,"88a8a02a89fffff",170,419,589
"6477",1970-01-01 23:30:00,"88a8a02a8bfffff",197,462,659
"6478",1970-01-01 23:30:00,"88a8a02a9dfffff",84,210,294
"6479",1970-01-01 23:30:00,"88a8a02aadfffff",84,210,294
"6480",1970-01-01 23:30:00,"88a8a02ac5fffff",164,402,566
"6481",1970-01-01 23:30:00,"88a8a02ac7fffff",230,522,752
"6482",1970-01-01 23:30:00,"88a8a02ae3fffff",117,270,387
"6483",1970-01-01 23:30:00,"88a8a02ae7fffff",51,150,201
"6484",1970-01-01 23:30:00,"88a8a02aebfffff",66,120,186
"6485",1970-01-01 23:30:00,"88a8a03987fffff",111,253,364
"6486",1970-01-01 23:30:00,"88a8a03997fffff",111,253,364
"6487",1970-01-01 23:30:00,"88a8a039a1fffff",284,608,892
"6488",1970-01-01 23:30:00,"88a8a039abfffff",222,506,728
"6489",1970-01-01 23:30:00,"88a8a039adfffff",275,655,930
"6490",1970-01-01 23:30:00,"88a8a039b9fffff",222,506,728
"6491",1970-01-01 23:30:00,"88a8a039bbfffff",342,712,1054
"6492",1970-01-01 23:30:00,"88a8a039bdfffff",113,252,365
"6493",1970-01-01 23:30:00,"88a8a06085fffff",53,149,202
"6494",1970-01-01 23:30:00,"88a8a0608dfffff",155,449,604
"6495",1970-01-01 23:30:00,"88a8a060a3fffff",53,149,202
"6496",1970-01-01 23:30:00,"88a8a060a7fffff",53,149,202
"6497",1970-01-01 23:30:00,"88a8a060abfffff",53,149,202
"6498",1970-01-01 23:30:00,"88a8a060c3fffff",53,149,202
"6499",1970-01-01 23:30:00,"88a8a060c7fffff",60,103,163
"6500",1970-01-01 23:30:00,"88a8a060cbfffff",0,0,0
"6501",1970-01-01 23:30:00,"88a8a06193fffff",53,149,202
"6502",1970-01-01 23:30:00,"88a8a06197fffff",53,149,202
"6503",1970-01-01 23:30:00,"88a8a0619bfffff",53,149,202
"6504",1970-01-01 23:30:00,"88a8a061a1fffff",113,252,365
"6505",1970-01-01 23:30:00,"88a8a061a3fffff",113,252,365
"6506",1970-01-01 23:30:00,"88a8a061a5fffff",164,402,566
"6507",1970-01-01 23:30:00,"88a8a061b1fffff",53,149,202
"6508",1970-01-01 23:30:00,"88a8a061b3fffff",53,149,202
"6509",1970-01-01 23:30:00,"88a8a061b5fffff",113,252,365
"6510",1970-01-01 23:30:00,"88a8a061b7fffff",53,149,202
"6511",1970-01-01 23:30:00,"88a8a06249fffff",333,644,977
"6512",1970-01-01 23:30:00,"88a8a0624bfffff",333,644,977
"6513",1970-01-01 23:30:00,"88a8a0624dfffff",333,644,977
"6514",1970-01-01 23:30:00,"88a8a06281fffff",60,103,163
"6515",1970-01-01 23:30:00,"88a8a06283fffff",60,103,163
"6516",1970-01-01 23:30:00,"88a8a06287fffff",60,103,163
"6517",1970-01-01 23:30:00,"88a8a06289fffff",120,206,326
"6518",1970-01-01 23:30:00,"88a8a0628bfffff",60,103,163
"6519",1970-01-01 23:30:00,"88a8a06293fffff",60,103,163
"6520",1970-01-01 23:30:00,"88a8a06299fffff",60,103,163
"6521",1970-01-01 23:30:00,"88a8a0629bfffff",60,103,163
"6522",1970-01-01 23:30:00,"88a8a062b5fffff",113,252,365
"6523",1970-01-01 23:30:00,"88a8a062bdfffff",113,252,365
"6524",1970-01-01 23:30:00,"88a8a062c1fffff",111,253,364
"6525",1970-01-01 23:30:00,"88a8a062c3fffff",171,356,527
"6526",1970-01-01 23:30:00,"88a8a062cbfffff",171,356,527
"6527",1970-01-01 23:30:00,"88a8a062d1fffff",60,103,163
"6528",1970-01-01 23:30:00,"88a8a062d3fffff",60,103,163
"6529",1970-01-01 23:30:00,"88a8a062d9fffff",60,103,163
"6530",1970-01-01 23:30:00,"88a8a06541fffff",60,103,163
"6531",1970-01-01 23:30:00,"88a8a06549fffff",60,103,163
"6532",1970-01-01 23:30:00,"88a8a06731fffff",120,206,326
"6533",1970-01-01 23:30:00,"88a8a06735fffff",120,206,326
"6534",1970-01-01 23:30:00,"88a8a06739fffff",60,103,163
"6535",1970-01-01 23:30:00,"88a8a0674dfffff",60,103,163
"6536",1970-01-01 23:30:00,"88a8a06a91fffff",60,103,163
"6537",1970-01-01 23:30:00,"88a8a06a9bfffff",159,337,496
"6538",1970-01-01 23:30:00,"88a8a06e4dfffff",53,149,202
"6539",1970-01-01 23:30:00,"88a8a06e6dfffff",60,103,163
"6540",1970-01-01 23:30:00,"88a8a06f05fffff",60,103,163
"6541",1970-01-01 23:30:00,"88a8a06f61fffff",60,103,163
"6542",1970-01-01 23:30:00,"88a8a06f63fffff",60,103,163
"6543",1970-01-01 23:30:00,"88a8a06f67fffff",111,253,364
"6544",1970-01-01 23:30:00,"88a8a06f69fffff",60,103,163
"6545",1970-01-01 23:30:00,"88a8a070b3fffff",273,541,814
"6546",1970-01-01 23:30:00,"88a8a070b7fffff",291,562,853
"6547",1970-01-01 23:30:00,"88a8a0719bfffff",120,206,326
"6548",1970-01-01 23:30:00,"88a8a07441fffff",215,552,767
"6549",1970-01-01 23:30:00,"88a8a07445fffff",111,253,364
"6550",1970-01-01 23:30:00,"88a8a07447fffff",53,149,202
"6551",1970-01-01 23:30:00,"88a8a0744bfffff",164,402,566
"6552",1970-01-01 23:30:00,"88a8a07461fffff",120,206,326
"6553",1970-01-01 23:30:00,"88a8a07469fffff",180,309,489
"6554",1970-01-01 23:30:00,"88a8a0746bfffff",284,608,892
"6555",1970-01-01 23:30:00,"88a8a07507fffff",153,335,488
"6556",1970-01-01 23:30:00,"88a8a07515fffff",180,309,489
"6557",1970-01-01 23:30:00,"88a8a0751dfffff",120,206,326
"6558",1970-01-01 23:30:00,"88a8a07521fffff",375,841,1216
"6559",1970-01-01 23:30:00,"88a8a07525fffff",324,691,1015
"6560",1970-01-01 23:30:00,"88a8a0752bfffff",273,541,814
"6561",1970-01-01 23:30:00,"88a8a0752dfffff",324,691,1015
"6562",1970-01-01 23:30:00,"88a8a07531fffff",531,974,1505
"6563",1970-01-01 23:30:00,"88a8a07535fffff",111,253,364
"6564",1970-01-01 23:30:00,"88a8a07537fffff",120,206,326
"6565",1970-01-01 23:30:00,"88a8a07539fffff",333,644,977
"6566",1970-01-01 23:30:00,"88a8a0753dfffff",0,0,0
"6567",1970-01-01 23:30:00,"88a8a07543fffff",104,299,403
"6568",1970-01-01 23:30:00,"88a8a07545fffff",53,149,202
"6569",1970-01-01 23:30:00,"88a8a07547fffff",102,300,402
"6570",1970-01-01 23:30:00,"88a8a07553fffff",120,206,326
"6571",1970-01-01 23:30:00,"88a8a07557fffff",120,206,326
"6572",1970-01-01 23:30:00,"88a8a07559fffff",53,149,202
"6573",1970-01-01 23:30:00,"88a8a0755bfffff",60,103,163
"6574",1970-01-01 23:30:00,"88a8a0755dfffff",104,299,403
"6575",1970-01-01 23:30:00,"88a8a07561fffff",333,644,977
"6576",1970-01-01 23:30:00,"88a8a07565fffff",111,253,364
"6577",1970-01-01 23:30:00,"88a8a07567fffff",213,438,651
"6578",1970-01-01 23:30:00,"88a8a07569fffff",164,402,566
"6579",1970-01-01 23:30:00,"88a8a0756bfffff",155,449,604
"6580",1970-01-01 23:30:00,"88a8a0756dfffff",477,1026,1503
"6581",1970-01-01 23:30:00,"88a8a07633fffff",164,402,566
"6582",1970-01-01 23:30:00,"88a8a07637fffff",164,402,566
"6583",1970-01-01 23:30:00,"88a8a076c7fffff",104,299,403
"6584",1970-01-01 23:30:00,"88a8a076d1fffff",164,402,566
"6585",1970-01-01 23:30:00,"88a8a076d3fffff",277,654,931
"6586",1970-01-01 23:30:00,"88a8a076d5fffff",111,253,364
"6587",1970-01-01 23:30:00,"88a8a076d7fffff",113,252,365
"6588",1970-01-01 23:30:00,"88a8a076e9fffff",224,505,729
"6589",1970-01-01 23:30:00,"88a8a076ebfffff",51,150,201
"6590",1970-01-01 23:30:00,"88a8a076edfffff",104,299,403
"6591",1970-01-02 00:00:00,"88a8a02801fffff",132,306,438
"6592",1970-01-02 00:00:00,"88a8a02805fffff",81,156,237
"6593",1970-01-02 00:00:00,"88a8a02809fffff",51,150,201
"6594",1970-01-02 00:00:00,"88a8a0280bfffff",132,306,438
"6595",1970-01-02 00:00:00,"88a8a02829fffff",33,60,93
"6596",1970-01-02 00:00:00,"88a8a0282dfffff",33,60,93
"6597",1970-01-02 00:00:00,"88a8a02853fffff",84,210,294
"6598",1970-01-02 00:00:00,"88a8a02857fffff",132,306,438
"6599",1970-01-02 00:00:00,"88a8a0291dfffff",33,60,93
"6600",1970-01-02 00:00:00,"88a8a02953fffff",33,60,93
"6601",1970-01-02 00:00:00,"88a8a02957fffff",33,60,93
"6602",1970-01-02 00:00:00,"88a8a02a05fffff",164,402,566
"6603",1970-01-02 00:00:00,"88a8a02a0bfffff",53,149,202
"6604",1970-01-02 00:00:00,"88a8a02a11fffff",53,149,202
"6605",1970-01-02 00:00:00,"88a8a02a13fffff",53,149,202
"6606",1970-01-02 00:00:00,"88a8a02a19fffff",113,252,365
"6607",1970-01-02 00:00:00,"88a8a02a1dfffff",53,149,202
"6608",1970-01-02 00:00:00,"88a8a02a57fffff",113,252,365
"6609",1970-01-02 00:00:00,"88a8a02a61fffff",51,150,201
"6610",1970-01-02 00:00:00,"88a8a02a63fffff",51,150,201
"6611",1970-01-02 00:00:00,"88a8a02a69fffff",164,402,566
"6612",1970-01-02 00:00:00,"88a8a02a6bfffff",113,252,365
"6613",1970-01-02 00:00:00,"88a8a02a89fffff",159,349,508
"6614",1970-01-02 00:00:00,"88a8a02a8bfffff",171,356,527
"6615",1970-01-02 00:00:00,"88a8a02a9dfffff",159,349,508
"6616",1970-01-02 00:00:00,"88a8a02aadfffff",185,455,640
"6617",1970-01-02 00:00:00,"88a8a02ac5fffff",113,252,365
"6618",1970-01-02 00:00:00,"88a8a02ac7fffff",212,498,710
"6619",1970-01-02 00:00:00,"88a8a02ae3fffff",152,395,547
"6620",1970-01-02 00:00:00,"88a8a02ae7fffff",152,395,547
"6621",1970-01-02 00:00:00,"88a8a02aebfffff",152,395,547
"6622",1970-01-02 00:00:00,"88a8a03987fffff",51,150,201
"6623",1970-01-02 00:00:00,"88a8a03995fffff",53,149,202
"6624",1970-01-02 00:00:00,"88a8a03997fffff",164,402,566
"6625",1970-01-02 00:00:00,"88a8a039a1fffff",51,150,201
"6626",1970-01-02 00:00:00,"88a8a039abfffff",51,150,201
"6627",1970-01-02 00:00:00,"88a8a039adfffff",51,150,201
"6628",1970-01-02 00:00:00,"88a8a039b9fffff",164,402,566
"6629",1970-01-02 00:00:00,"88a8a039bbfffff",224,505,729
"6630",1970-01-02 00:00:00,"88a8a0608dfffff",60,103,163
"6631",1970-01-02 00:00:00,"88a8a060c3fffff",51,150,201
"6632",1970-01-02 00:00:00,"88a8a060cbfffff",51,150,201
"6633",1970-01-02 00:00:00,"88a8a06193fffff",60,103,163
"6634",1970-01-02 00:00:00,"88a8a06197fffff",60,103,163
"6635",1970-01-02 00:00:00,"88a8a061a1fffff",60,103,163
"6636",1970-01-02 00:00:00,"88a8a061a3fffff",60,103,163
"6637",1970-01-02 00:00:00,"88a8a061a5fffff",113,252,365
"6638",1970-01-02 00:00:00,"88a8a061b1fffff",60,103,163
"6639",1970-01-02 00:00:00,"88a8a061b3fffff",60,103,163
"6640",1970-01-02 00:00:00,"88a8a061b5fffff",60,103,163
"6641",1970-01-02 00:00:00,"88a8a061b7fffff",0,0,0
"6642",1970-01-02 00:00:00,"88a8a06249fffff",60,103,163
"6643",1970-01-02 00:00:00,"88a8a0624bfffff",60,103,163
"6644",1970-01-02 00:00:00,"88a8a0624dfffff",60,103,163
"6645",1970-01-02 00:00:00,"88a8a06281fffff",102,300,402
"6646",1970-01-02 00:00:00,"88a8a06283fffff",51,150,201
"6647",1970-01-02 00:00:00,"88a8a06287fffff",51,150,201
"6648",1970-01-02 00:00:00,"88a8a06289fffff",153,450,603
"6649",1970-01-02 00:00:00,"88a8a06293fffff",120,206,326
"6650",1970-01-02 00:00:00,"88a8a06299fffff",120,206,326
"6651",1970-01-02 00:00:00,"88a8a0629bfffff",120,206,326
"6652",1970-01-02 00:00:00,"88a8a062b5fffff",51,150,201
"6653",1970-01-02 00:00:00,"88a8a062bdfffff",51,150,201
"6654",1970-01-02 00:00:00,"88a8a062c1fffff",102,300,402
"6655",1970-01-02 00:00:00,"88a8a062c3fffff",153,450,603
"6656",1970-01-02 00:00:00,"88a8a062cbfffff",153,450,603
"6657",1970-01-02 00:00:00,"88a8a062d1fffff",180,309,489
"6658",1970-01-02 00:00:00,"88a8a062d3fffff",120,206,326
"6659",1970-01-02 00:00:00,"88a8a062d9fffff",240,412,652
"6660",1970-01-02 00:00:00,"88a8a06541fffff",60,103,163
"6661",1970-01-02 00:00:00,"88a8a06549fffff",120,206,326
"6662",1970-01-02 00:00:00,"88a8a06705fffff",120,206,326
"6663",1970-01-02 00:00:00,"88a8a06707fffff",120,206,326
"6664",1970-01-02 00:00:00,"88a8a0670dfffff",60,103,163
"6665",1970-01-02 00:00:00,"88a8a0672bfffff",60,103,163
"6666",1970-01-02 00:00:00,"88a8a06731fffff",60,103,163
"6667",1970-01-02 00:00:00,"88a8a06735fffff",60,103,163
"6668",1970-01-02 00:00:00,"88a8a06739fffff",120,206,326
"6669",1970-01-02 00:00:00,"88a8a0674dfffff",120,206,326
"6670",1970-01-02 00:00:00,"88a8a0676bfffff",120,206,326
"6671",1970-01-02 00:00:00,"88a8a06a91fffff",60,103,163
"6672",1970-01-02 00:00:00,"88a8a06a9bfffff",113,252,365
"6673",1970-01-02 00:00:00,"88a8a06e49fffff",60,103,163
"6674",1970-01-02 00:00:00,"88a8a06e4dfffff",60,103,163
"6675",1970-01-02 00:00:00,"88a8a06e6dfffff",60,103,163
"6676",1970-01-02 00:00:00,"88a8a06f05fffff",0,0,0
"6677",1970-01-02 00:00:00,"88a8a06f61fffff",60,103,163
"6678",1970-01-02 00:00:00,"88a8a06f63fffff",60,103,163
"6679",1970-01-02 00:00:00,"88a8a06f69fffff",0,0,0
"6680",1970-01-02 00:00:00,"88a8a070b3fffff",60,103,163
"6681",1970-01-02 00:00:00,"88a8a070b7fffff",60,103,163
"6682",1970-01-02 00:00:00,"88a8a07193fffff",60,103,163
"6683",1970-01-02 00:00:00,"88a8a0719bfffff",120,206,326
"6684",1970-01-02 00:00:00,"88a8a07441fffff",228,380,608
"6685",1970-01-02 00:00:00,"88a8a07443fffff",60,103,163
"6686",1970-01-02 00:00:00,"88a8a07445fffff",233,458,691
"6687",1970-01-02 00:00:00,"88a8a07447fffff",108,174,282
"6688",1970-01-02 00:00:00,"88a8a0744bfffff",279,530,809
"6689",1970-01-02 00:00:00,"88a8a07461fffff",392,782,1174
"6690",1970-01-02 00:00:00,"88a8a07465fffff",272,576,848
"6691",1970-01-02 00:00:00,"88a8a07467fffff",120,206,326
"6692",1970-01-02 00:00:00,"88a8a07469fffff",60,103,163
"6693",1970-01-02 00:00:00,"88a8a0746bfffff",341,632,973
"6694",1970-01-02 00:00:00,"88a8a07507fffff",702,1330,2032
"6695",1970-01-02 00:00:00,"88a8a07515fffff",222,391,613
"6696",1970-01-02 00:00:00,"88a8a0751dfffff",60,103,163
"6697",1970-01-02 00:00:00,"88a8a07521fffff",402,815,1217
"6698",1970-01-02 00:00:00,"88a8a07525fffff",102,185,287
"6699",1970-01-02 00:00:00,"88a8a0752bfffff",495,1047,1542
"6700",1970-01-02 00:00:00,"88a8a0752dfffff",444,897,1341
"6701",1970-01-02 00:00:00,"88a8a07531fffff",1002,1845,2847
"6702",1970-01-02 00:00:00,"88a8a07533fffff",60,103,163
"6703",1970-01-02 00:00:00,"88a8a07535fffff",153,450,603
"6704",1970-01-02 00:00:00,"88a8a07537fffff",120,206,326
"6705",1970-01-02 00:00:00,"88a8a07539fffff",444,897,1341
"6706",1970-01-02 00:00:00,"88a8a0753bfffff",60,103,163
"6707",1970-01-02 00:00:00,"88a8a0753dfffff",180,309,489
"6708",1970-01-02 00:00:00,"88a8a07543fffff",272,576,848
"6709",1970-01-02 00:00:00,"88a8a07545fffff",221,426,647
"6710",1970-01-02 00:00:00,"88a8a07547fffff",159,324,483
"6711",1970-01-02 00:00:00,"88a8a07553fffff",120,206,326
"6712",1970-01-02 00:00:00,"88a8a07557fffff",60,103,163
"6713",1970-01-02 00:00:00,"88a8a07559fffff",272,576,848
"6714",1970-01-02 00:00:00,"88a8a0755bfffff",120,206,326
"6715",1970-01-02 00:00:00,"88a8a0755dfffff",272,576,848
"6716",1970-01-02 00:00:00,"88a8a07561fffff",444,897,1341
"6717",1970-01-02 00:00:00,"88a8a07565fffff",60,103,163
"6718",1970-01-02 00:00:00,"88a8a07567fffff",444,897,1341
"6719",1970-01-02 00:00:00,"88a8a07569fffff",272,576,848
"6720",1970-01-02 00:00:00,"88a8a0756bfffff",108,174,282
"6721",1970-01-02 00:00:00,"88a8a0756dfffff",335,758,1093
"6722",1970-01-02 00:00:00,"88a8a07633fffff",219,427,646
"6723",1970-01-02 00:00:00,"88a8a07637fffff",279,530,809
"6724",1970-01-02 00:00:00,"88a8a076c7fffff",51,150,201
"6725",1970-01-02 00:00:00,"88a8a076d1fffff",51,150,201
"6726",1970-01-02 00:00:00,"88a8a076d3fffff",111,253,364
"6727",1970-01-02 00:00:00,"88a8a076d5fffff",173,355,528
"6728",1970-01-02 00:00:00,"88a8a076e9fffff",51,150,201
"6729",1970-01-02 00:00:00,"88a8a076ebfffff",51,150,201
"6730",1970-01-02 00:00:00,"88a8a076edfffff",99,221,320
